哈哈 我 是 kipsta 的 qpl	哇  带 我 飞
15年 1月 左右	蒙自路 那 套 是 老 工房 吗  价位 呢
没有 衣柜 	有 衣柜 但是 不大
有木有 阳台 呀	没有 阳台
最快 什么时候 可以 入住 	这个月 月底
这个月 月底	什么时候 可以 看房子 呢 
什么时候 可以 看房子 呢 	下 个 周末 吧
很喜欢  但是 要 8月 底 才能 搬家 啊	这个 可以 谈 啊 呵呵
在 淮海路上 班  有车 到 吗 	很 近 很 近
何时 方便 看一下 	随时 等你 电话
马 了	欢迎 来看房
欢迎 来看房	什么时候 可以 去 看 呢 
什么时候 可以 去 看 呢 	都 可以 今晚 也 行
那 豆 下 电话 吧	微信 rkki 38
有 阳台 吗  几 楼  这 床 多大 	无 阳台 二楼 双人床
能 住 两个人 么 	住 不下
upup	你好 请问 房子 还在 吗
二房东   	麻烦 把 二 去掉
问一下 哪里 晾 衣服 啊  顺便 帮 up	衣服 就 直接 晾 的 窗外 阿
有 阳台晒 衣服 么 	没有 阳台  但是 可以 晒 衣服
恩  春节后 跟 你 联系	恩好 的
价格 可 刀 吗 	2年 多 前 就 租 的 2800 了
哟	乃 又要 换房子 了 
记得 两年 前 的 价格 是 2500	没错 4年 多 前 是 2200
多少 米	2500
价格 有 商量 不	抱歉 没有 不好意思
本月 中下旬 可 看房  圣诞节 可 入住	是 相册 的 那一套 还是 现在 这套 
是 相册 的 那一套 还是 现在 这套 	就是 这一套 啊 亲
就是 这一套 啊 亲	soga 哪天 去 看 下 房子 吧
soga 哪天 去 看 下 房子 吧	可以 的 吧 估计 要 下 个 周末
可以 的 吧 估计 要 下 个 周末	好 滴 下周末 约 下 时间 吧
有 阳台 晾晒 吗	2 边 的 窗户 都 可以 晾晒
请问 是 多少 平米 的 呀 	19 左右
可以 住 两个 	可以 住 但是 肯定 很 挤
也 出租 不过 暂时 还 没 到期	可以 了解一下 那 套 租期 到 何时 吗 
可以 了解一下 那 套 租期 到 何时 吗 	15年 1月 左右
93 默默 飘过	薄荷酱
83  看来 已经 老 了   	大叔 原来 还在 江阴 组 混 呢
帝都 	一样 
小雏菊 小 纯洁 小 单纯	不是 小雏菊
及时 赶到	到 不了
梅雨帘	脸
一剪梅	梅雨帘
哈哈  月黑风高 陈奕迅	告诉 他 我爱 他 邓丽君
梦醒 时分	分手快乐
质感	感同身受
离爱 不远 张宇	原来 你 什么 都 不想要
原来 你 什么 都 不想要	要说 什么 hebe
来生缘	原谅 把 你 带走 的 雨天
人间	剪爱
控制 狂 苏打绿	绿光 孙燕姿
爱情 转移	一剪梅
歌唱 祖国	国家
国家	嫁妆
来 就 来了	了解
我爱 他 丁当	他 不爱 我
笔记 周笔畅	记得 林俊杰
写 一 首 歌	歌未央
歌未央	阳光
999 朵 玫瑰	归去来
原谅 把 你 带走 的 雨天	天黑黑
绿光 孙燕姿	光辉岁月 beyond
下一站 天后	后来
姐姐 妹妹 站起来	来不及
到 不了	了不起 的 盖茨比
多一点	点解  点解  beyond
点解  点解  beyond	解脱
解脱	陀飞轮 陈奕迅
陀飞轮 陈奕迅	轮 车
轮 车	没有 刷新  我错了 
没有 刷新  我错了 	嘻嘻
情非得已	一路 两个人 梁静茹
一路 两个人 梁静茹	人在雨中 张学友
人在雨中 张学友	终生美丽 郑秀文
终生美丽 郑秀文	离爱 不远 张宇
离爱 不远 张宇	愿 张敬轩
愿 张敬轩	原点 蔡健雅
三人 游	有 故事 的 人
解脱	妥协
妥协	写 一 首 歌
嫁妆	装酷 哈林
装酷 哈林	哭砂
哭砂	杀破狼
杀破狼	浪花一朵朵
浪花一朵朵	多一点
你 最 珍贵 张学友	轨迹
轨迹	寂寞 先生 曹格
歌未央	我们 写 的 一样  我 比 你 晚 了 一步 
我们 写 的 一样  我 比 你 晚 了 一步 	真 默契  神 同步
真 默契  神 同步	对啊  这个 太难 遇到 了 
对啊  这个 太难 遇到 了 	喜欢 杨宗纬 
喜欢 杨宗纬 	很喜欢 听 他 的 歌 
很喜欢 听 他 的 歌 	同  这 概率
年轻 的 战场	长相思  这样 谐音 可以 麽 
人来人往 医生	忘情水
长相思  这样 谐音 可以 麽 	思念 是 一种 病
剪爱	爱情 万岁
夜曲	曲终人散
曲终人散	三人 游
离爱 不远 张宇	缘分天空 孙楠
缘分天空 孙楠	控制 狂 苏打绿
雅鲁藏布江	将 爱情 进行 到底
想你 的 夜  	夜曲
di da di	第一次
雨 一直 下	下雨天  南拳妈妈
后来	来生缘
感同身受	受了点伤 阿桑
将 爱情 进行 到底	di da di
挂 在 半梦半醒 之间	剪爱
写 一 首 歌	歌未央
歌未央	样子 嘻嘻
阳光	光辉岁月
光辉岁月	月半湾
月半湾	弯弯 的 月亮
弯弯 的 月亮	量 身 定做
量 身 定做	作主
作主	祝福
祝福	浮躁
浮躁	早 开 的 晚霞
恋爱 达人 	人间
告诉 他 我爱 他 邓丽君	他 一定 很 爱你 阿杜
他 一定 很 爱你 阿杜	你 最 珍贵 张学友
后来	来
来	来 就 来了
思念 是 一种 病	冰雨
来 个 经典 笑红尘 陈淑桦	尘埃落定 张敬轩
尘埃落定 张敬轩	定风波 张学友
定风波 张学友	波斯猫 她
波斯猫 她	猫 的 冒险 周笔畅
我 的 头像 怎么样  笑 得 很 阳光 是 吧	盗梦 空间 
盗梦 空间 	哈哈哈  文艺 小 逗比 小 身板 囧 色 夫
哈哈哈  文艺 小 逗比 小 身板 囧 色 夫	赞
你 又 翻 陈年 老账	人 老 了 就 伤感 怀旧 
我 想 打麻将 了 	来 俺们 宿舍
dq 和 宠爱 之 名 哪个 好 	我 用 的 dq 感觉 非常好
绝对 有用  我 就是 亲身体验  	美女 你 拔完牙 带 牙套 了 么
马 一个	mm
看到 这 为什么 哭 了 	mark
m	亲 我在这里 看到 你 了
亲 我在这里 看到 你 了	哈哈  肉肉 无处不在
在 爱里 的 人们 都 很温柔 啊	不能 同意 更多
和 喜欢 的 人 一起  怎样 都是 好 的 吧	是 
在 爱里 的 人们 都 很温柔 啊	真好 
太 浪漫 的 人  往往 无 法学会 生活 	同感
此刻 若 你 不爱 我  我 也 不在意	1 mark 一下
此刻 你 虽 不爱 我  我 也 不会 在意 	恩
说 的 好	客气
客气	一直 做不到 鱼 和 熊掌 不可兼得
话说 你 蒸 到 汉子 没 	没 啊
济南 173	好 高
大连 小棍宁	漂亮 棍 娘 啊 
无锡 的 剩女 报道	齐天大圣 吗  求 认识
苏州  	找到 了  苏州 的  哈哈
找到 了  苏州 的  哈哈	握 抓 w
第一个 昆明 的 来 报道	果然 昆明 就你 一个
大明湖	容嬷嬷
江苏 无锡 172	啊  无锡 的 终于 找到 了
安徽 的 还 有木有 	蚌埠 的
蚌埠 的	握爪 合肥 的
难道 重庆 这么 弱 吗	重庆 握爪 
济南	济南  求 配对
济南  求 配对	额  你 在 什么 地方 呢
额  你 在 什么 地方 呢	历下区  你 呢
历下区  你 呢	大明湖
支持	谢谢
上班 了 也 不能 认输 	对 
ls 说 哪位 同学	说 的 是 那个 要 中考 的 gn
很厉害 加油 我 也 27 共勉	共勉 
支持 	加油 
我 也想 变成 一个 厉害 的 人	从 今天 开始 努力 
能 追寻 自己 的 脚步 就是 快乐 的 	点头 
你好吗  祝福	还不错 啦 谢谢你 的 祝福 
要 等 这么 久  蛋痛 啊	年轻人 不要 急
感动 于 理想 地 生活 的 状态 	脑子 发热 没法 长久 啊
脑子 发热 没法 长久 啊	恩 
恩 	不是 吗
不是 吗	脑子 发热 是 泛指 吗 
脑子 发热 是 泛指 吗 	当然 是 啦 
那 也 就不 叫 脑子 发热 了 应该	嗯 哈
嘿    这 是 叫板 吗 	不用 叫板 啦 陈述 事实 而已
加油 	谢谢
要 先 入世  才 谈 得 上 出世  赞同 	nod 
赞	嘿嘿
慢慢来 	嗯  继续加油 
的确如此 感同身受 t t	亡羊补牢 为时 未晚 
感觉 怎么样	要 持续 练 下去 
喜欢 这 句  加油 	谢谢  共勉
加油 哈 	共勉
工作 与 生活 的 美好	加油 
好 的  非常感谢   	不客气 啦
恭喜 呐	谢谢谢谢
加油	加油 
我 回来 了  考 完 中考 了 	可以 尽情 玩 啦 
真的 有变 厉害 哦  学习 之	头像 特 给力 了   
也 考虑 想 考	好好 努力  有 想法 要 付诸 行动 哈
举 抓 o ( v ) o	什么 意思 啊
   同 大龄  同 努力	好好 加油 啦 
嗯  努力	共勉
喜欢 最后 一句话  共勉	共勉
要 有 年轻 的 心	我 尽量
本人 22 岁 要 进化成 更好 的 人	大好 青春 可以 争取  加油 
25 岁 的 来 给 你 加油 	一起 加油 啊 
1	加油 吧
哈哈  谢谢姐 	姐 是 口头禅  我 比 你 小
有 觉悟 的 小朋友	哈哈
加油	谢谢 共勉
你 27 了 么 	那个 朋友 肯定 没有 吧  哈哈
加油 哒 	加油 
考托福 的 算不算    	你 27 了 么 
什么时候 马拉松 报名 啊	8 9月 份 可以 关注 下
自我 不是 找到  而是 创造	用 第一 帖 的 那 句 来回应
嗯嗯  大叔 也 年纪 轻 着呢	嘿嘿 努力 吧 
加油	3 q
行动力 啊 行动力   	我 会 加油 的
我 会 加油 的	加油 啦 
顶 签名 	哈哈
路过  共勉  加油 	谢谢  波塞冬 的 矛 不错 
点头	一起 加油 
我不知道 浪费 了 多少 余暇	每个人 都是 这样
好 的  主持人 喜欢	)
人 老实  再 聪明 也 像 傻瓜 	这个 想知道 什么 意思 
支持	3 q
leiou 加油  	谢谢谢谢 
考托福 的 算不算    	1
果然 出现 了 	出现 什么 了 
大家 都 好 努力 好 上进	加油 啦 
26 一同 努力	加油 
来了 来了  加油 噢	)
恩 初心 好	嘿嘿  是 的 
同岁  面临 同样 的 困扰	握手
长江 后浪 推 前浪 	前浪
加油 大叔	谢谢
健康 事业 安全 人脉 	good
我以为 是 女孩    囧	让 你 失望 了
10.17	我也是 10.17
1989.10.21	比 我 大 一天
1019	同日 生  握个手
10.16	同 10.16 握个手
大 一 天 	孩子  你 哪 的 
我有 一种 莫名 的 很 爽 的 感觉	1 
被 你们 说 的 我 都 想 去 掏 掏   	我决定 双休 去 掏 掏 看
最后 你 会 掏出 一颗 毛茸茸 的 花生米	正解
回复 大 亮	这 是 10年 的 坟 啊   
若 调整 机身 该 调整 那个 位置 	法兰 距离
用 生姜 头发 会不会 有味道	很 淡 的  头发 干 后 就 几乎 闻 不到 了
你 应该 是 雄 性激素 过 高	啊 那 怎么办 呢 
现在 还 在一起 吗 	在一起 吖 
在一起 吖 	祝福 羡慕
姐弟恋 吗	额 对 的
那天 加 群 的 是 你 不	是 的 是 的
是 的 是 的	冒 个 泡
冒 个 泡	我看 大家 都 不 在线   
走 到 现实 了 啊	真幸福  真羡慕 你们
我 现在 的 老公 不是 网络 喔 	网恋
啊    这么 久 了 还有人 看	嗯
大 腐 国 的 未来厨神 你好  	厨艺 太 烂
楼楼 还在 吗	还在 啊  还在 啊
d 5 的 男友 总是 这么 极品 	你 竟然 敢 挖坟  
必须的  握爪 	握爪
痞子 英雄 有 她 吗    是 ab 吧	是 电视剧 版 的
今年 还有 聚会 过年 活动 不 	当然有  看 这里
秘密 呢   	在 灵异 组 的 水楼 继续
新年快乐	新年快乐
哦 呵呵 早上好 啊 你 回归 了	回归 了 嘿嘿
10090 吧 不能 再 瘦 了 	嗯嗯 94-5 就 挺好 的 了 
对 的 	彩子 和 宫城 必须 在一起 
丫 不是 喜欢 仙道 吗	这 怎么回事
反正 不是 晴子 就 行  哼	    也是     
好东西	m
血液 循环 不好 体寒	支持
我 的 情况 跟 你 说 的 一模一样 	好久 前 的 贴 了 都 被 你 翻 出来 了 囧
蒽  商务 英语 专业 	以后 从事 什么 方面 的 工作  外企 吗
忘了 说 早安	兔子    耶耶    
诗音 加油 啊  	好久不见 啊 亲    
于是 我 又 换 回 我 的 大狗 了	我最爱 狗狗 了   哈哈哈
可是 我 还是 想 翻页	六六 你 太 可爱 了 哈哈哈
龙年 吉祥	小鹿 吉祥  哈哈 
加油 	谢啦  你 也 加油
考场 下 了  宾馆 订 了  蒽  就 酱紫	诗音 加油  一定 会 如愿 的 
加油 	( )  一起 干巴爹
同好	握爪  
为什么呢  那个 三头 驴 的 故事	因为 小贤 也是 驴
清明 想来  北京 过来 好 远 哦	北京 还好 呢
过年 初三 来 推荐 嘛	不 推荐 冷 哈哈哈
不 推荐 冷 哈哈哈	啊 可是 只有 过年 有假
啊 可是 只有 过年 有假	囧 那个 囧
囧 那个 囧	囧 了 个 再 囧
囧 了 个 再 囧	好 吧 嘿嘿
简历 已 发送	好 的  会 尽快 给 回复 的
好 的  会 尽快 给 回复 的	啊 谢谢
我看 微博 说 下雪 啦    	是 的 额   
可怜 之 人 必 有 可恨 之 处	哈哈哈 说 的 好 
可怜 之 人 必 有 可恨 之 处	正解
history	历史 哲学 也 很 有趣
历史 哲学 也 很 有趣	）
本科 哲学	那 就业 呢
那 就业 呢	想 考研 吧
想 考研 吧	来回 就 那么 回事 吧 
喜欢喜欢 加 群 吧 	没有 群 啊 
没有 群 啊 	看 这里  进来 吧  
看 这里  进来 吧  	好 的
10	let it be
好像 有点 相亲 的 味	相亲 也 不 反对 哦
原来 素 相亲 涅	呵呵 也 不是 完全 相亲 啊
一年 了 你 还 没找到 吗	知音 难觅 啊
诶 呀 我也是	猿粪  
华丽 一 翻	恭喜你
机场 到 这里 怎么 走	机场 大巴
火车站 打的 多久 到 	最多 10 分钟
么 问题 啊	店家 好人
晚上 十一 点 到 西安 能 去 你 家住 么 	当然可以 欢迎 你 啊
太 详细 了	嗯嗯  真心 好贴 
嗯嗯  真心 好贴 	看 这个  出去玩 方便 很多
还 真 全  住 朵拉 很方便 哦	喜欢 朵拉 
哈哈哈 	恩  很 热闹  店里 人 都 好好 啊
真的 么 真的 么 真的 么   	欢迎欢迎
恩  这 话说 得 好 	西安 很 有 感觉  跟 穿越 了 一样
想 去 西安 	来 呗  你 肯定 很喜欢
来 呗  你 肯定 很喜欢	之前去 过 一次  不过瘾 啊 
好帖   	就是 好贴 
哦哦 那 要 提前 多少 时间 预定 啊	最好 是 三天
打算 七 八月 去 呢	来吧
嗨 呀 一定要 来 啊 哈哈	改天 一起 看电影 啊
嗨 呀 一定要 来 啊 哈哈	恩恩 呢  下次 一定要 去 
马克之	大爷  你 的 发型 不错  
马克之	大爷 好   
我 怎么 记得 是 她 哥哥   看着 老相	是 的  是 女主 的 哥哥
老乡 啊  校友 啊  	cumter 
淮安人 在 徐州  大三 了	同 是 淮安人  在 徐州  大三
这 是 去年 的 好 么	soga
哥  只 爱 刘姥姥 	哥 你 有 大智慧
一年 了  快  时间 真快 	freak
  你 每次 说话 都 好凶 阿 	其实 我 很温柔
这个 是什么 电影 	原来 是 武馆  没注意 看 标题
嗯啊 挑 个 好日子 赶紧 办 了 把	恩恩恩  ( 3 )
我 已经 不爱 他 了 哦 也	你 确定 么 亲 
我 有计划  有计划  没有 目的地 	那你 等于 没有 计划 啦
没有 计划 也是 计划	我 有计划  有计划  没有 目的地 
我 举  	哎
哎	哎哎
哎哎	都是 浮云 啊 亲
我想说 这 两个 星座 经常 很 狗血	狗血淋头 的 两个 星座 啊   
heheh	咋 了
亲 偶 也是 最后 一个 暑假	工作 快 两年 了  鸡蛋饼 君 
陈亦迅 的	医生 的 歌 音调 好 低 诶 
葫芦娃	亲 您 傲娇 了
死了 都 要 爱	吼 过  直接 飙 高音 
有木有 什么 粤语歌 推荐 	死性不改
一不小心 就 翻 了 个 页	亲  奖 你 小红花 哟   
好冷 的 小组	亲  来火 一把 呗
亲  来火 一把 呗	肿 么 火
09 土 资  城 院 人 真 少	不少
06 土 资	学姐 现在 何处 了
04 土 资	又 发现 一个 土 资
味全  在家 喝 白帝  卫岗  新鲜 啊	南京人 
恩 还有 手机 电话簿	是 的 你 也 晓得 哇
应届 毕业 的 可以 吗	可以 的  详情 请 见 网申 地址
模式识别 的 在这里	你 学 模式识别 主要 搞 些 什么 呢 
你 学 模式识别 主要 搞 些 什么 呢 	准备 弄 视频 监控 一类 的
夭夭 素 好人   	好人 晚安
我在 横店 经常 看见 梅菜 肉饼 	不好吃
哟 吼 竟然 翻页 了 	啊 多谢 啦
见面  然后 捏  	就 吃 了 个 饭 呗
商务 助理 有 什么 要求 	灵活  肯干  踏实  有 条理  就好
啥 电影 	泰坦尼克 号 啊
嗯 恭喜 要 珍惜	谢谢 mua
作死 的 节奏	已经过 去 两年 了 好嘛 
我 也 觉得	谢谢 亲 关心 了
谢谢 亲 关心 了	当年  这 是 当年 的 事情 
不 为了 谈恋爱 而 谈恋爱  	为了 在一起 而 享受 爱情
最 浪子 的 人 岂非 是 杨过   	铁了心 不是 杨过 
宫 二 头肌	赞 
想起 了 宫崎骏	1
还在 嘛  亲	不在 啦
我 忽然 觉得 我 什么 都 不知道	我 就 知道 好 耳机 很 贵
这 是什么 啊  具体 	关注 我 微博 啊 
在 你 微博 上 搜 吴姓 小虎	o
o	你 微博 什么 名字 啊 
猫咪 放弃 式 拥有 你 都 关注 了 的	好嘛  我 不晓得 哪个 是
都 学 坏 了	谁 学 坏 了 
for what 	for fun
咋 啦  	惊现 道场
武汉 男童鞋 路过 	头像 是 你 自己 吗  萌 受 
ddd	你 还 没 蒸 到 啊   帮 你 顶顶 吧 
你 还 没 蒸 到 啊   帮 你 顶顶 吧 	你以为 很容易 呀   
不是 良家	额    你可以 的 这么 回答
310 开头 是 神马 意思 啊 	上海 土著 身份证 号 前 三位
不是 上海 的 可以 么 	离 上海 近 的 也是 可以 的
比 你 大一点 可以 么 	如果 感觉 好 的 话 我 不介意 的  
六安 不适合 玩  适合 生活	太 对了
万佛湖  天堂寨  白马尖    	恩  我家 就 在 万佛湖
电玩城 电影院	风云 再起 吗 亲
风云 再起 吗 亲	忘了  反正 红街 3 楼 有 哦
请问 有 住 的 地方 吗	有啊
你 说 的 这些 听 起来 好像 都 还不错 唉	对呀 在 大别山 原始森林
一样  极 喜欢	我 也 喜欢 组长 
我 也 喜欢 组长 	哟 哟 切克闹 
被 你 这么 一说 还 真 会 应验 的	啊 我 乌鸦嘴 了 么
啊 我 乌鸦嘴 了 么	乌鸦
乌鸦	到 
已经 结婚 了  谢谢 大家 	是 跟 当时 那个人 么
已经 结婚 了  谢谢 大家 	恭喜
好 多学 日语 的 人	你 也是 吗 
好  地址  不过 可以 寄信 么	可以  豆油 你 地址
ls 这个 很 不 靠谱 吧	ls 你 有 什么 要求 
打 错 了  是 约  美女 约么 	我在 国外  所以 肯定 约 不了
确定 的 	好 吧 留下 联系方式
lx 豆油	ls 豆油 了 lx qq
我 只 会 唱 青藏高原 lx 来	我 只能 唱 天路 lx 继续 唱
ls 我 也想 你	lx 表 得瑟
恩  武汉 	额  我在 山东
赞    	男人 来了  为何 迟迟 不 来 觐见 
男人 来了  为何 迟迟 不 来 觐见 	赞 男人  哀家 来了 
ok 了 楼下 我 也 要 豆油	我 也 要 豆 邮  
你 应该 发 个 美腿 啊	发 美腿  我 也 只 发给 它 了
发 美腿  我 也 只 发给 它 了	我 喝酒 你 也 看不到 阿
我 喝酒 你 也 看不到 阿	         
         	
lx 给 我 唱 首 歌	你 不 遵守 规则
楼下 恋爱 一周 吧	好呀  ls
找 男友 发泄	介 个   木有  
哈哈 跟 你	真够 直接 的
绝对 不 信	你 忘了 留 问题 啦
豆 你  拿 什么 豆 你	哥哥 的 神韵 犹 在
lx 和 我 勾搭	ls 同意 哈
就不 扮 	你 都 不 遵守 游戏 规则   哼  
我爱 lx 跳个舞 吧	说 打 了 个 我 字 唉
你 这个 怎么 断了 呢  lx 的 呢 	ls 我 忘了 lx 中午 吃什么
ls 这个 坐标 哈  不行 的 嘛	你 是 女 的 嘛 我 飞过 去找 你 噗
羞射	依稀  你 还会 害羞 
不 靠谱 的 勾搭  武汉 太远 鸟	唉唉  悲催 了 t.t
不行 胃口 太重 了 你	怎么 重口味 了 啊
怎么 做  lx 今天 会 下雨 么	谈 一个 星期 的 恋爱吧
是 男 的 就 搞基  女 的 就 走 起	搞基 万岁 啊
搞基 万岁 啊	咱俩 走 起
me too	你 不是我 lx 嘛 
少见 的 it 文青  顶顶顶	不敢 说 文青  需要 脑 补 而已
一 碰 水 就 黑 真心 吃不消	上 油 碰 水 也 黑 么 
报个名 咋 联系 	豆油  提供 联系方式 
下月 回国 成都 招 不	哦  平时 拍 着 玩 的  随时 都 需要
哦  平时 拍 着 玩 的  随时 都 需要	行 到时候 来 成都 联系 吧
哈哈  脸 圆 行 么	我 想 没什么 问题 吧 
好呀 	请问 肿 么 联系 咧
请问 肿 么 联系 咧	扣扣 1274806118
email	必须 是 女生
来 个 邮箱 发 个 资料 给 你	email
报名 呗	欢迎
时间 上 有 具体 要求 不	大家 都 闲 的 时候 就好 
额  这个  好像是 友邻 啊 	你 确定 
你 确定 	你 果断 认 不 出来 我 
这 是 谁 用 的 	溏心风暴 里 的 细 鲍
溏心风暴 里 的 细 鲍	恩  我 听 了  果然 是 陈豪 把 声 
hiahia 是什么	拟声词
想知道 性教育 那个 是什么	亲 你 在 装 纯 么  挤眉弄眼
沙 主 位置 在 哪 呀	屏惠家园 and u 
屏惠家园 and u 	在 哪  自 水厂 边上 那个 
在 哪  自 水厂 边上 那个 	787 公交 站 那里
787 公交 站 那里	供电所 对面 
供电所 对面 	bingo
已 汇总 到 汇总 贴	tks
那 没有 缓解 办法 么 	有  正心
这个 帖 沉 了 	疑似 沉 贴  还 没 沉
你 这 是 要 诠释 什么 问题	呃 有 什么 好处 和 坏处 吧
老师  不要 跳过 我 啊  看 这里	木星 和 土星 的 实力 相当
你 应该 先 去 学习 做 时空中 点 盘	
大家 继续 哦	您好  在 吗  
是 这个 意思 吧 	恩
让 我 直接 看盘	好 的     谢谢 了  
确实 啊  难 嫁	具体 怎 讲 
具体 怎 讲 	具体 还 得 全盘 考虑
本 帖 不做 占星 咨询 哦	老师 不要 忽视 我 啊
但是 星座 本身 是 有 吉凶 的 对 吧 	星座 本身 也 没有 吉凶
组合 盘 宿命 刑天 王一定 会 分手 吗	不一定  这不 是 重点
上升 在哪里  天顶 在哪里	上升 狮子座 天顶 金牛座
ean 老师   请 给 我 建议	我 记得我 已经 给 你 回复 了  你 找找
你 应该 找 专业 占星师 看一下	( o ) 不知 去哪 找 呢 
沟通 工作	3 q
别 沉 了  自己 回 一个	此 贴 只 解答  不 看盘
土星 合群 星 啊	并且 群星 摩羯
遇到 了 麻烦你 hold 不住	额 该怎么办
火 土 6 合 了 啊 	努力工作  保重 身体
努力工作  保重 身体	我 就这样 还有 事业 么  t t
我 就这样 还有 事业 么  t t	有 事业 啊  别 灰心
技术性 的 行业	谢谢 老师 
额 该怎么办	火 土 6 合 了 啊 
想 问问 命 主星 怎么看 	上升 星座 守护星
你 发图 好 吗	好 的
基本 理解 正确	o ( ) o  谢谢
5 宫 宫 头 处女  2-8 宫 被 截 	5 宫 被 劫 夺 就 很正常 了
你 土星 在 2 宫 吗	求 大师 收徒
你 土星 在 2 宫 吗	土星 在 3 宫 诶
你 应该 去找 一 份 庙 旺 落 陷 表	谢谢你 的 指导
忽略 什么 了	我 的 三个 问题 四条 回复  
我 的 三个 问题 四条 回复  	是 吗
土星 的 能量 会 被 木星 良好 的 引导	多谢 老师 的 耐心 解答 多谢
和 另一半 结实  因为 钱 或者 性	婚后 关系 比较 结实 是 吗  
你 的 问题 很 复杂  建议 详细 咨询	好 吧 谢谢 老师
亲  这种 数据 我 看不懂  我要 看盘	豆 邮 给 你 
豆 邮 给 你 	可以
桃花 多 可能 与 7 宫主 和 天王 有关	能否 解释 一下 呢 
ean 请问 职业 发展方向 看 什么 	天顶 所 落 的 星座
你 邮箱 是	我 的 豆瓣 主页 有
这个 暂时 无法 回答 你	囧  不 传 之 秘 
我 也 要买 个 	欢迎欢迎
好 了	原来如此  辛苦 了 
是 滴   	在 北京 工作 吗 嘿嘿
那你 有 去 法国 玩吧	有的   我在 巴黎 呆 过     
不用 啊    刚刚 查 了 下  	额 这个 帖子 是 一年前 的 了
额 这个 帖子 是 一年前 的 了	额       
额       	你 订 好 票 了  嘿嘿
你 订 好 票 了  嘿嘿	木有    
木有    	好 吧 你 在 北京 上学 啊
果然 是 中 画幅 狂人	买 了 徕卡 真心 穷 了
我 估计 也是 这天	也是 捷星 杭州 出发 莫 
和 你 一天 到 呵呵	我 3.4 号 到 奥克兰
是 么   还 蛮 标准 的 天蝎 粑粑 麻麻	是 挺 标准 的    可 真 苦 了 我 了 
是 挺 标准 的    可 真 苦 了 我 了 	那 我 也 将 苦 了 我 的 孩纸 tat
几号 的 白羊	415
我爱 白羊 我爱 白羊  我 是 狮 纸 	你 是 有 多 渴
冒 个 泡	欢迎
冒泡  大家 都 什么时候 过去 啊 	随时 都 可以 过去  只要 让 去就 行
bravo 	bienvenu
你 进展 怎么样 了	备料 ing  你 呢
备料 ing  你 呢	这 2 天 准备 递交 材料
中枪 了   	中几 枪 
2 完全 可以 是 褒义词	好事 成双 的 意思 
qq 够 2 的 哈哈全 是 2	   就是 个 巧合   
帮顶	多谢 
青年 杂志 人物 类	有名 吗  
打不开 了  	我们 被抛弃 了 
我们 被抛弃 了 	恩   淡淡 的 哀愁   
没有 不和 的 星座  只有 不和 的 人	会 死
会 死	哪个 会 死 乜  这 很重要
173 允许 进 么  ( )	可以 呀
来 南宁 把	亲  包邮 么 
亲  包邮 么 	不 倒贴
m	地址 豆 邮 我 呀 还有 片片 选 了 么
已经 m 了 换片 愉快	好 的 哇 换片 愉快
反 了	呵呵     我以为 我 搞错 了
来 我 办公室 吧 	亮 你
给 他 看到 这个 帖 就 行 了	后援 贴 怎么可以 泄露   嘿嘿
自定义 游戏	very good
真的 不能 议价 嘛   	真的 哦 亲  我们 又 不是 中介
可以 两个人 住 么	你 豆油 我 吧 亲 
朝向	窗户 朝东  特别 安静 
复	谢谢你 啊
高端黑 	组里刚 有人 爆 了 照片  自己 鉴别
小清新	难道 在 说 我 么 
耳闻 不如 目见 ( )	多谢 夸奖 的
少侠 好 身手	过奖
不懂 在 说什么 啊	意思 是 我 是 刘少侠 
孩纸  你 误会 我们 了	
为 毛 是 新年  不是 元旦 嘛 	终于 有人 对 这个 吐槽 了
mark	thanks
我 不太 喜欢 西塘	西塘 感觉有点 被 过度 开发
恩  不错  祝你好运 	谢谢
快 过年 了  	对啊 新年 快乐
8 错	谢咯
暑假 去	玩 得 开心 哦
有米 有照片    	有
喜欢喜欢	谢谢
mark  我 会 再来 的	谢谢
好地方  mark	mark 万岁
挺 想 去 呢	去 吧 千万 不能 错过 哦
今天 刚 从 西塘 回来  不错不错	求 分享 要 看 照片     
闲 呢 好无聊    肩膀 都 闲 酸 的	能 闲 是 福      
我 十天 没 洗头 了 	很 享受 这 过程 吧
舌头 疼   	话说 多 了  
2012 会 对 你 很好 的	借 您 吉言 喽
不是 歌词 么 这个	什么歌 啊  科普 一下
happy b day  	thank u
生日快乐  新年快乐  大家 快乐	新年快乐 
陌生 的 你  生日快乐 	谢谢  新年快乐 哦 
生 快	嗯  3 q
生日快乐	谢谢  新年快乐 
哈哈  逗你玩 实在 太 有意思 了 	   怎么 好像是 大人 逗 小孩 呢
是 大宝哈哈    羞涩   	羞涩 你妹  反正 你 搞基 
羞涩 你妹  反正 你 搞基 	      我 搞 你妹
      我 搞 你妹	怎么办  只有 一个 弟弟 
欢迎 哦 亲  你 真 跟 男友 分 啦 	你妹 啊  
你妹 啊  	哈哈 
生日快乐 思密达 	额  谢谢 思密达 
好 吧  阿里嘎 头 	   这不 是 日语 从来
哥 也是 学 日语 的 	   我 发音 还算 标准 吧   
   我 发音 还算 标准 吧   	标准 我 回 让 你 从 说 
标准 我 回 让 你 从 说 	纳尼 
纳尼 	搜地 死 内
生日快乐	恩恩  谢谢  新年快乐 
生日快乐	谢谢啦  新年快乐 
不管 怎么样  开心 最 重要 	嗯  好好 生活 
生 快	恩恩  谢谢 
生日快乐 	嗯  3 q  新年快乐 
生日快乐	谢啦  最爱 咖啡  嘻嘻 
回声 生日快乐 	嗯  谢谢  都 要 幸福 我们 
试 没 试 过 脚踏 好 几 条 船	我 以前 叫 脚 踩 万 条 船 一条 也 不 翻
能 爱 就是 好 的  我 都 不会爱 了	为什么 你 不能 哎 了
爱 的 人 很少  睡 的 人 也许 会 很多 	不敢 睡 啊 睡 了 还要 负责任
有 40 码 的 么	弱弱 的 说句 有   
接受 价位 报上来 	房 在 哪
房 在 哪	其实 呢  你 已经 逛 过 我 的 窝 了
果断 要 啊	那 咱们俩 一起 租吧 
那 咱们俩 一起 租吧 	我 是 真的 要 租 诶  下半年 呢
不会 骑车	我 带 你 就 ok 啦   哈哈哈 
我 想 在 国贸 附近  去哪 都 方便 了	国贸 好 是 好  但是 房子 又 贵 又 烂
定福庄 传媒 二外 附近  男 	帮 你 顶顶
花轮 同学 我 是 美 环 同学 啊	美 环 同学  你来了
是 吧 光 够 足	是 的 够 足
hi  baby	hi  baby
花轮 童鞋       你 比 我 小 	哦 哦 哦哦
哦 哦 哦哦	哦 什么 哦  一点 都 不 靠谱 
英村 儿 来 一个	同村 儿 你 哪 的 
同村 儿 你 哪 的 	london 村 儿 的 你 咧 
london 村 儿 的 你 咧 	在 曼城 这边 哇
今年 9月 去 o	英国 欢迎 你
英村 的  握个手 	村子 i 的 伤不起
苦逼 的 英村     	超级 酷毙
我 好想去 英国 啊   555	lailailai
曼城 太远 了	where r u 
where r u 	bristol 的
学 日语 的 想 去 英国 表示 无力 	kelian
kelian	是 的 
标题 好 正 紧 啊    伯村 飘过	波闽汗 的 人 不 给力     哈哈
在 哪个 村 啊    	小村    你来 么 
明年 看 能不能 混 到 英村 啊 	今年 就 来 啊
你 在 曼城  我 离 曼城 很 近 的 说 	bujanbusan
英 村 党 路过	leeds
既然 想 好 了 那 就 做自己 想 做 的 呗	嗯 懂 啊 了
我 也 在 曼城 附近 啊啊啊 	where
你 在 哪儿 	勾搭 就 告诉你
默默 过来 坐等 爆 点   	搞基 么 
你 在 哪个 学校 呢 	农大
买 一条 pataginia w 4	偶 是 死 宅 好不 啦    
买 一条 pataginia w 4	偶 是 死 宅 好不 啦     
西开	已经 西 到 太平洋 了 
我 有啊  要不  刚好 两 张	杯具    
坏银呀 我来 围观   	你 也 可以 试试
那 拖 着 个 线头 呢 妹纸 多 不舒服	要不  你 试试  hiahia
orz	
哪 买 的 多少 价格	自己 找  不贵
自己 找  不贵	你 是 网购 的 嘛
你 是 网购 的 嘛	计生 团 你 去 这个 网站 看看
拿 电钻 按 上 橡胶棒 是不是 更 爽	啊 哈哈哈 哈哈哈哈 友邻 你 亮 了
偷 瞄 看看	还要 偷 瞄
哈哈 哈哈哈  扯 证 需 谨慎 	我 也 没有 说 对 你 说 早 生 贵子 
掩面 溜走 	不准 走
掩面 溜走 	一声 叹息
海德薇 之 歌 百度  下载	谢谢 亲 哈
都是 追梦人	与 君 共勉 
与 君 共勉 	共勉
标记 下学期 课 少 的 话 想 试一试	欢迎欢迎
可能 从 三月份 开始 不会 迟 吧 	期待 你 的 到来
住 宿舍 的 咋办 捏 	没办法 了
有 洁癖 的 男生 要 sp 	sp 是  
support	thx
我也是 新人	你 哪有 是 新人    
你 哪有 是 新人    	真的 咩  
低调	红人 
红人 	红毛 
美 不过 夕阳红   红人	你 小心点 
你 小心点 	肿 么 啦  肿 么 小心 
好像 认识	你 快 想想  
我 觉得 我 认识 了 	真的 么   
次 凹   你 认识 我 咩 	你 化成 灰 我 就不 认识 你 了
你 化成 灰 我 就不 认识 你 了	不要 学 他 他 是 魂 淡
你是谁 o	大灰狼    来 找 小红帽
不 认识  你 谁 啊 	我 是 你 亲 姐姐 阿乖 弟弟
t.t 你 丧 害 了 我  却 一笑 而 过	嘿嘿 嘿嘿 嘿嘿 嘿嘿嘿  
你 化成 灰 我 就不 认识 你 了	    
反正 我 不 认识 你	   我 也 不 认识 你
   我 也 不 认识 你	我 很 低调 的 好 咩
我 很 低调 的 好 咩	我 比 你 还 低调 诶  
那多 没意思	好 吧   其实 我 才 更 低调   
好 吧   其实 我 才 更 低调   	那 你为什么 冒 出来 了  
一 张嘴 就 露馅	我 哪有  
次 凹	换个 词 这个 太 熟
真的 不记得 我 是 新人	我也是 新人
我也是 新人	握手
握手	握爪
握爪	是 手
是 手	爪子 
爪子 	好 吧  你 的 爪子  我 的 手
好 吧  你 的 爪子  我 的 手	不是 你 的 是 爪子 我 的 是 手
不是 你 的 是 爪子 我 的 是 手	no
no	我 的 是 爪子 你 的 是 蹄子
我们 今天下午 报到	好好学习 天天向上 噢
闷 罐 牛肉	没 吃 过   
好 吧  你 牛逼	还好 吧 嘿嘿 吃 啊 你 饿 不
我 肯定 是 饿 啊  那 我 也 不能吃 	瘦 多少 了 亲
马克西姆小面 球儿	没 吃 啊        
我 做 给 你 嘛 	厨师 啊  
纯粹 没 水平	等到 四点半 木有 人
蛮 就 睡 了  晚安 啊 亲	安 表 落枕 了 亲
   	起 得 好 早
deja vu	【 已经 看过 】 
你 学 什么 专业 的	工程造价
上 新安 人才 吧 少年 	去 试试
加 你 qq 了	恩  呵呵
关注	呵呵  谢谢 关注
在 脸上 贴 一个 弯 字	    噗 哈哈   
上 个 真相 吧  帮 泥 研究 研究 嗯	真相 有啊  
只能 上 豆瓣 辨认 了 哈哈哈	哈哈哈 我 笑点 好 低
在 脸上 贴 一个 弯 字	好 想法  
花线 了 好多 友邻 	嗨 摸头
友邻 你好 	嗯 横 3
友邻 你好 	所以 我 果断 决定 回家 剃头   
所以 我 果断 决定 回家 剃头   	嘻嘻 支持
型号 是 dir-605  没问题 的	谢谢
我 躲闪 高 	那 我 还有 固定 伤害 技能 
那 我 还有 固定 伤害 技能 	那 我 就不 躲 了 
这个 太难 了	早起 还是 早睡
多钱 海大 学生 想 住 啊	750
你 终于 灭 了 15000	可歌可泣 啊  值得 出去 庆祝 下
可歌可泣 啊  值得 出去 庆祝 下	心酸  又要 熄灯 了 
心酸  又要 熄灯 了 	我们 也是  你 回 学校 了 
看来 我们 学校 不错 嘛	是 的 某些 方面 比 复旦 好
我 还以为 动手 了     	亲  你 的 楼 更 完了 吗   
其实 不对 的 是 你 	呵呵 慢走 不 送
不 咬人  有照片	求 狗狗 真相
您说 的 一点 没错  不过 不是 相对	那 肯定 是 并排 坐在 一起 
应该 是 小明 那 厮 删 的 楼 	哈哈哈  树 妹儿
小明 好 认真  冰冰 好 认真 	冰冰 是 么子 
那你 见过 在 大家 上 大炮 的 么 	在 大家 上 大炮 咩 意思 啊
好 高深 小清新 的 我 着实 听不懂	
你 哦 是 晓得 的 了 	他 自己 说 的 
我 就 晓得 是 你  这个 id 好 蠢 	她 什么时候 灵 放过     
莉莉 是 中传 的    	嘘 这个 要 保密 
嘘 这个 要 保密 	太 信不过 我 哒    
那 肯定 是 并排 坐在 一起 	哈哈  冒  我 坐沙发  他 坐 板凳
莉莉 是 中传 的    	我 看成 中专 的 了
这个 倒是	你 这根 墙头草     
我 就 晓得 是 你  这个 id 好 蠢 	别 告诉我 是 小白 啊 
别 告诉我 是 小白 啊 	就是 她 
我记得 ls 分手 发过贴 	那 没有  你 认错人 了
我 也 愿意    	谁 来 把 我 变成 血族 
我 初拥 过来	真 哒 谁 拥 得 你  我 也 要
ls 是 坏人	你 皮 痒 了 
奔跑 吧 青春 	没 热水 了
没 热水 了	回来 了 亲
居然 是 小 钢牙   	天哪    亲爱的    
你 推倒 了 大头 	谁 是 大头   
谁 是 大头   	你 的 媳妇 啊          
嘛 叫 端正 的 男人	你 该 问 嘛 叫 体位 端正 的 男人
你 说 的 事 是 嘛 意思 	你 懂得  
你 懂得  	我不懂  你 继续 吧
天津 小女 一般 都 什么 消费水平 	每月 花费 3000
索尼爱立信   	现在 那 牌子 是不是 改成 sony 了
怎么 望京 的 都 不上 豆瓣 吗 	我在 福马
好 怀念 秦唐一品家 的 大盘鸡	大 归 大  全 是 土豆 现在 涨价 了
懒	懒 点 没什么 不好
懒 点 没什么 不好	无解
无解	不懂 了 吧
不懂 了 吧	不懂
ni 几 楼 的 啊 	嘿嘿  我 也 在 d座 呢  播 思 通讯 嘛
ni 几 楼 的 啊 	2111
我在 福马	福马 在 哪儿 健身 
福马 在 哪儿 健身 	上班 啦
星城 国际 算 望京 不	星城 国际 在 哪 啊
跟 lzmm 一个 楼	您 几 层 啊 
技不如人	怕 啥子  可以 学 练习 滴
他 肯定 不止 偷 一个 哦	那 就 真的 不少 了    
好 清新  赞 一个	你 是不是 又 换 名字 了  
我 克 点点 买	点点 的 实体店 在哪里 
丫丫 我 还有 30元 的 优惠卡  哈哈	纸微 姐姐 跟我说 表 买 yy 的 耶
点点  跟 39 差不多	谢谢 我 今天 考试 回来看 看   
这些 好多人 都 和 你 有 仇 吧	木有 啊
原创  那 太 佩服 你 了 	嘿嘿  谢谢  必须 是 自己 码 的 帖
广岛之恋 这歌 写 的 很 黄 	没有 啊 好不好
等 天晴 了 去 晒晒 干 就好 了 哈	已然 发霉 了
已然 发霉 了	发霉 了 也 能 晒 好 的 亲
发霉 了 也 能 晒 好 的 亲	霉 花 三 弄 晒 不好 了 亲
霉 花 三 弄 晒 不好 了 亲	好 吧 给 你 一 熨斗 现在 就 熨 好
演戏 呢	怎么 演戏  
你 这种 状态 指 的 是 我 还是 他	他
他	天蝎座 怎么 这样    
演戏 呢	1
第四条 我 笑 了  	笑笑 更 欢乐
明显 是 你 的 心理 防线 不 巩固 	没 试 过 的 别 乱说  实践 检验 真理
不 我 的 出发点 是 清新 的	结果 是 重口 的  
这个 标题  真 像 广告 用语	我有 做广告 的 天赋 不是 
提前 祝开心 自在 	谢谢叻  好人 哦
  	感叹号 爪子
这 就 完了  i	完了 撒 还 想 爪子
我们 聊聊 人生 聊聊 国策 吧	人生  人生 多美 好  不 觉得 么
这 是 y p 贴 嘛 	其实 这 是 钓鱼 帖
看 这名字 就不 怎么 敢 看 哎  	就是 讲 的 三十岁 剩男 剩女 的 故事
这个 要求 简单  亲	别走 啊 亲  
其实 这 是 钓鱼 帖	求 被 钓  鱼饵 在 哪儿 呢 
求 被 钓  鱼饵 在 哪儿 呢 	鱼饵 啊   鱼饵   是 大家  
那 你猜 我 多大	芳龄 19
芳龄 19	  太小 了 吧 阿嚏
  太小 了 吧 阿嚏	您 自爆
聊聊 农民工 吧	嗯 农民工 咋 了  
新疆  嗯  南 北疆 一 圈 要点 时间 的	啊 乃 去过 吗
那 我们 聊聊 房价 吧	房价 好 您 起 个头
一听 口音 就 认得 是 老乡	老乡 
老乡 	昆明 呢 撒
难道 不应该   	早知道 我应该 留 着 当年 那 台 小小白
   我等你 的 豆油 	耍赖 是 小狗 哦 亲
顶一下 	谢谢  急 呢 
我 是 在 敏感 些 什么	这个 怎么了 
你 该 去 医院 看看 神经科 了	  为什么 
为什么 侮辱 你们 的 智商 了 	我 也 觉得 在 污辱 智商 啊
狮子 男 出现 一下 	没事 
我爱 狮子 	你 中毒 了 
我 金牛 啊 	恩
你 已 被 豆 邮 赤果 果 的 包围着 	都 不对 的  哎
哈哈 谢谢 乃 的 祝福 	客气 了 噢 亲
狮 女 	爱你
我 也 在 听 呐 亲 	亲 个  哈哈
嗯 	你 有 好运 哈哈
不管 你 懂 不懂 反正 我 懂 的 	我 也 懂
我 也 懂	嗯 嗯嗯 
必须 懂 阿  呵呵 	就这样  狮子 很 有爱 
我 又 来了	老小孩 
我 又 来了	干吗 呀    
干吗 呀    	逗你玩
你好  我 又 来了	nihao baibai
我 是 狮 男	恩 拜拜  
狮子座 躺着 也 中 箭	扫瑞 
我 是 狮 男  无视 我  更 受 打击 了 我	木糖醇 什么 味道
香甜 可口  吃 多 了 会上 隐 哦  亲	咳咳
狮子 男 靠边 观望	哈哈 哈哈哈哈 呵呵 
我 来看看	随便 看 
也 不是 	额 那 就 搞不懂 了 亲
额 那 就 搞不懂 了 亲	你不懂 我 
你不懂 我 	是 的 是 的
是 的 是 的	拜拜  生气 
拜拜  生气 	额 自以为是 哎
狮子 不是 很好 么	是 好呀 
我 天蝎 型 的 狮子 好 么   	天蝎 真心 没 研究 
放弃 你 	再见 
想象力 好 丰富 噢	不要 打击 我
不要 打击 我	夸 你 呢 
夸 你 呢 	那 谢谢你
因为我 也想 变成 你 的 亲人	真好 
来  目的 单纯 的 抱 一下	为什么 都 要 抱  
水瓶男 飘过  	不 好不好
看开 就好 了  经验 满 了 才会 升级	不想 升级 
不想 升级 	年轻 还 不 折腾  等 死多 没意思
还好 我没有 星座	阿凡达 吗 
原来如此 何惧 	不 惧  狮 女 从来不 惧 
阿 	狮子男 还是 很好 的 
我 是 狮子 男 啊   	再见 
啊 	先 告诉我 你 喜欢 什么 星座 的 男人
狮子 怎么了 啊 惹 你 了 吗	没有 没有 没有
狮 男 尴尬 的 飘过	躺着 也 中枪 了 
躺着 也 中枪 了 	是 啊  哈哈
是 啊  哈哈	扫瑞 
不太 懂你	你 懂 我 就 邪门 了 
最多 不看 了 买 望远镜 还要钱	如此 美景 哪 是 钱 能 衡量 的   
如此 美景 哪 是 钱 能 衡量 的   	qq 表情 里面 有个 吐 的 
qq 表情 里面 有个 吐 的 	qq 表情 里面 也有 一个 崇拜 的
qq 表情 里面 也有 一个 崇拜 的	屁 
屁 	相信自己 相信 党
相信自己 相信 党	相信爱情 吗 
嗯哼 我们在一起 可以 打麻将 	我们 两个 还 可以 玩 升级   
我们 两个 还 可以 玩 升级   	您 真爱 升级 
您 真爱 升级 	嗯 真爱  没治
嗯 真爱  没治	没有 真爱  
天秤 男 可以 报名 不  	说 了 除了 狮子 都 可以 
狮 女 走过 	好 巧
jesus	阿
阿	你 认识 jesus   
你 认识 jesus   	不 认识
年底 真是 生意兴隆	           
           	不是 吗 你看 都 翻 三页 了
那你 呢	我 什么 都 没有 
我 呢  处女男	除了 狮子 都 好 
月抛 帖 势如破竹	10086
我们 稀饭 乃 啊   	尊 的 嘛 亲         
什么时候	今天下午 我 都 ok 
喉咙痛 咳嗽 ing	祝 早 好    好 了 去 拼 吧 亲  
我 现在 每天 不 看书 就 头疼	好 乖 啊
感觉 人 很 空	像 没有 目标 似的
那 应该 不难 吧 0.0	该 学校 自主 划线
昨晚 我 梦见 我 又 考 英语 了	灰 常 担心 英语 的 说
服务员 说 研究生 下课 了	恩恩  
每天 睡觉 看电视 上网 好无聊	确实 很 无聊 就是 发呆
it 就是 挨 踢	好 吧
欠 踢 呗	什么叫 欠 踢  
老家伙 了 	同 老
老歌	昨天 听 了 一天  刚 起
向来 情深 奈何 缘 浅	情深缘浅
斩 了 千 次 的 情丝 却 断 不了	你 太 文艺 了 
我 刚 唱 完 这首歌 有没有	缘分  
为何 你 还 来 拨动 我 的 心跳	恩哼
突然 波动 了 我 的 心跳	没事儿 孩子   
没事儿 孩子   	没事 没事 没事
没事 没事 没事	恩  乖 
这个 曾经 不 完整	完整 了 还能 叫 曾经 么
完整 了 还能 叫 曾经 么	唉  覆水难收
过去 了 都	对 嘛 那 就好
对 嘛 那 就好	恩恩  谢谢你
从 标题 到 头像 到 id 俱 是 小清新 	恩恩  你 么 
有机会 组 局 唱歌 去 	那 我 就 露 怯 了
为何 你 还 来 拨动 我 心跳 	爱你 怎么能 了
爱你 怎么能 了	今夜 的 你 应该 明了
今夜 的 你 应该 明了	缘 难 了
缘 难 了	情 难 了
情 难 了	还好 刚才 我 没 一下 唱 完
那 说明 你 心 还 没 死 	人 不死  心 不死 
人 不死  心 不死 	恩  应该 这样  可惜 做不到
我 得 这辈子 先 抱紧 了 再说	我 倒是 想 抱 呢
下辈子 还 想 遇见 他 	下辈子 还 想 再 遇上 他
突然 波动 了 我 的 心跳	为何 你 还 来 拨动 我 的 心跳
我 看成了 原来 还能 生	噗
走 了 	恩  走 了 
噗	同 噗
去 庙会 疯 疯 	第一次 听 这个 网站 还是 因为 他 
第一次 听 这个 网站 还是 因为 他 	挺好  那 就 记着 吧 
挺好  那 就 记着 吧 	不过 这种 音乐 我 还是 接受 不了 
不过 这种 音乐 我 还是 接受 不了 	音乐 没啥 重要 的 
音乐 没啥 重要 的 	你 发那 伴奏 不错
小可爱  你 肿 么 了 	没事 呀  发烧 了  现在 烧 退 了 
没事 呀  发烧 了  现在 烧 退 了 	病友  你好  隐退 吧 
一个 系列 的 表白 贴 	表 什么 白 呀  这 都 何种 境地 了 
没错  没错   	o ( ) o 哈哈哈
都留在 今年 	恩  恍惚 的 我 年初 好像 年末 
恩  恍惚 的 我 年初 好像 年末 	龙年 还 没 来
龙年 还 没 来	对  还 没 来  还 没 来 
大 过节 的 都 好好 的	恩  都 好好 的 呢 
恩  都 好好 的 呢 	瞎说
b	你 哈哈哈
你 哈哈哈	我 懂你 
b	biu biu
biu biu	啊 啊
哎呦	兔子 好
红儿	恩 
没错  没错   	有你 什么 事  去 一边 去 
哥  回去 跟 老弟 喝酒 	小红  回来 了 么 
等你	你 总是 等 我  好 基友 
啊 东 吧   	 
傻     	能动手 尽量少 吵架
能动手 尽量少 吵架	能动手 早 动手 了 啊  
求 节目	115 盘
瘦肉精	应该 是 妖怪
演 华妃 的 叫 什么 啊啊啊	蒋欣 记得 有个 楼 扒 过 她 啊
是 啊 后来 好像 温仪 也是 她 养 的	温宜 是 端妃 养 的
温宜 是 端妃 养 的	额   o ( ) o 记错 了
有没有 其他 的 地址  求 啊 求  	效果 没 76 集 这种 的 好 哈
有木有 地址    求 地址   	我 是 在这里 看 的  快播
我 是 在这里 看 的  快播	恩   我 下 播放器 了  
就是 那个 绿 衣服 的 仙女   	她 还是 新新 天龙八部 里 的 木婉清
所以 你 的 id 是 阿诗玛 是 么   	我 卖 啊 亲  
我 卖 啊 亲  	有啥 啊    我 q 加 不 起来 人 了
sams club	所以 你 的 id 是 阿诗玛 是 么   
疼 死 额	玩耍 起来 吧 亲
买	1 要买 抓紧 了
今天 还是 发 年终奖 的 日子   	尼玛 我们 公司 木有 年终奖
刚 给 领导 送 完 礼 邮件 给力 啊	你 送 什么 了
汾酒 找 山西 的 同学 寄 的	真 下 血本 啊  看来 你 要 升职 加薪 了
汾酒 找 山西 的 同学 寄 的	你 送 我 两 瓶 被 
mark     求 聊天   	聊天
没有 啊  一点 不懂 莜麦	数据 见 我 id   ）
数据 见 我 id   ）	知道 你 身材 好
知道 你 身材 好	） 你 在 哪 的
） 你 在 哪 的	alberta  canada
alberta  canada	  好 远
  好 远	那你 在 哪
那你 在 哪	我在 荷兰  
大麻 蘑菇 可卡因	长腿 大胸 biubiu
好 吧        快 天亮了 都	原来 不是 时差 党 更 暖心 了
原来 不是 时差 党 更 暖心 了	阿 我在 中国 噢       
同 伤感   时差 党 的 痛苦 啊  	习惯了 就好 了 ( )
哈哈哈  鼓掌	我 脑子 有点 抽 住 了   
  恩 赶紧 的	恭喜你  我没有  
那 倒 不是 额 不熟 不喝 额	赞   
无聊 的	我 也 觉得          
哈哈哈	毛骨悚然 的   
毛骨悚然 的   	是 惊世骇俗 
等 回家 的 车  哎 z	祝 回家 顺利 啊 
已 豆油	已 回 豆油 
恭喜你  我没有  	哦哟
弄 最近 哪天 低调 了	欢乐 版聊 什么 地方 不 低调 了 啊 
无聊 伐         	恩  无聊 的 
硕大  力量  肌肉 的 肩膀 来了	我喜欢 踩 柔弱 的 小 肩膀
我喜欢 踩 柔弱 的 小 肩膀	莫有  肿 么 办
老师 又 眼红 了	又  
哎  撒宁噶 好心 删贴 了   	无 啊 想 晓得 撒 拧 
阿拉 上路 伐 v	恩  猫猫 最 嗲 了
哎 啊 拉 不好意思 说 	噗  弄 乃么 吐露 心声 了
好 偷偷 溜 测 来 伐 啦	起 阿里 啊 
一起 简化 吧 亲	好 的 好 的
一般 值得 回 的 贴 才 认真 回	谢谢你 这 黱 认真 的 回 覆  
谢谢你 这 黱 认真 的 回 覆  	orz
我们 一起 拉黑 的 人	噗 好 创意
好 吧  陈信宏 大人  	嘿嘿 迷 妹 谢谢你
陈信宏 不 认识  五月天 了解 	陈信宏 是 阿信 的 本名    
谁 是 陈信宏	五月天 阿信   
五月天 阿信   	他 我 不 就 认识 了
好 吧  要加 先生 二字 不 	不用 加大 人 就 行
不用 加大 人 就 行	
不 打扰  是 我们 的 温柔 	不 打扰  多好 
求 传递 啊  豆 邮	已经 豆油 了 哦  继续 传递 哎
求 豆 邮 求 传递 谢谢 啊	以 豆 邮
求 豆 邮	求 传递 （ 目 ）
老师  我等 你好消息	email
求 激活码  豆油 谢谢 	已 发送
就 两个字 好 小气	安慰 你
安慰 你	小 花朵
小 花朵	啊 
你 会 孤老 一生	你妹 啊  你 就 不会 说 点 安慰 的 话
可以 考虑 考虑	来
来	你 要 给 我 介绍 吗 
你 要 给 我 介绍 吗 	好呀 我 给 你 介绍 好 基友
秃驴  竟敢 跟 贫僧 抢 师太	方丈 我 再也 不敢 了
撒娇 是 一种 技巧  而 不是 一种 习惯	心里 拿 不住 那个 度
自古 2 l 出 人才	10086
挽尊	谢谢 与 君 共勉
谢谢 与 君 共勉	麻痹 忘记 了  新年快乐 啊  
大 过年 的	难道 是 吓 着 红花 尊主 了 么    
请问 有 字幕 吗 	已 上传 英文 字幕
已 上传 英文 字幕	谢谢
太 好 了 谢谢  	不用谢
有 字幕 吗 有 压力 啊	已 上传 英文 字幕
已 上传 英文 字幕	感谢 嘿嘿
以前 看过	看 的 有点 乐 哈哈  
信息 蛮 多	是 说 拍 的 太 乱 了 吗 
展现 自己 最美的 一面 唯一 的 方法	有没有 具体 一点 的 
条件 忒 好不 靠谱  呵呵   	哈哈  楼上 亮 了
北京人 不是 事儿 多  是 嘴 贫 ）	嘴 贫 也 分 人  不是 逮 谁跟谁 贫 
兄弟  利群 还 可以	利群 一般  而且 北京 也有
好像 挺 漂亮 的 样子	漂亮 谈不上 啦  长 的 比较 干净
漂亮 谈不上 啦  长 的 比较 干净	哈哈  乾净
可惜 坐标 北京  加油	谢谢啦
还 没 蒸 到 么	有缘 的 少
77年 的 我  人 很 靠谱 的	    大叔  
上海 女人 都 很小资    挺好 的 	虽然 你 说 的 很 勉强  但 谢谢
虽然 你 说 的 很 勉强  但 谢谢	帝都 男人  也许 你 懂 的 
帝都 男人  也许 你 懂 的 	魔都 女 拧  你不懂
千万 别 多想  哥哥 是 直男  	懂 的
    我有 说 么   	好 吧  单纯 的 我 上当 了 
还 没 被 领 走 呢 	靠谱 的 人 真是 不 多 啊
就 当 你 是 吧	你 别 这么 不 肯定   
同 是 财务  帮顶 	thx
很好  很小  很 可惜 	谢谢  很 老  很遗憾 
哪里 呀  还 不是 你 不理 我们 	也许 觉得 不适合 呢
可惜 坐标 北京  加油	谢谢啦
一定要 乔装打扮 下	是 吧  我 也 觉得 
是 双色球 吗     	嗯  双色球 
montblanc 不 解释	太贵太贵穷人家 孩子
只 买 过 万宝龙  中兴	有 2000 以下 的 嘛  
我 是 鬼  好不好	聂小倩 吗
你好  我 是 假 组 一 爸	阿和 哈哈 哈哈哈 和 哈哈 哈哈哈 
阿和 哈哈 哈哈哈 和 哈哈 哈哈哈 	你 是 假 组 的 神马
好好笑	笑 啥 有啥 可笑 的
真相     上	我 觉得 我 就 一点 不 爷们儿
装 是 不对 的 	没有 装 是 真的
你    不承认 算 咯	哦  回国 之前 的 事 你 都 记得 到
哦  回国 之前 的 事 你 都 记得 到	那 可不
姐们儿  一起 加油	嗯 哪  为了 幸福
您 这 是 长期 招人 么	yes
哈哈 这样 有 内涵 是不是 啊 	我 本来 也有 内涵
我 本来 也有 内涵	我 靠 这个 一点 也 美 发觉
拍打       	旋转 拍打       
跪求 虐 巨蟹 的 方法	其实 最 重要 的 还是 他 爱你
别 别  你 要 争 口气 啊	我没有   
吃素 脾气 还 那么 大    	还是 和 秉性 有关 吧
搜 一下 王凤仪 讲 人生  真心 有用 	我 会 去 好好看 看 的 
怎么 这么 可怜 呢	倒霉 催 的 唉 就 这 命 了
正解 爱无能	肿 么 办  
加油	嗯 
加油  调整 好 状态	谢谢你
踢 死 ls 的 我来 挽尊	如果 是 穿裙子 的 话  欢迎
如果 是 穿裙子 的 话  欢迎	裙子 里面 穿 棉裤 的
裙子 里面 穿 棉裤 的	说好 的 天然 少女 阿拉蕾 呢 
说好 的 天然 少女 阿拉蕾 呢 	长大 了
你 认错人 了 	哦
初八	说话 
已经 删 好友 了   	乃 们 为 熟 么 都 嫩 么 果断   
我 给 bf 单建 一个 组   	   有 几个人 了    
亲   你 给 我 力量 了 亲  	必须的 啊        
香菜  没 吃 过	香菜 猪 肉馅 没 吃 过 
香菜 猪 肉馅 没 吃 过 	是 哇 不知道 香菜 能 做 馅 儿 呢
我 觉得 你 无时 不 刻 不再 啊	不能够  总得 干 别的 是 不 
不能够  总得 干 别的 是 不 	啊 是
啊 是	比如 吃喝 什么 的 
比如 吃喝 什么 的 	那 其他 时间 都 在 啦
那 其他 时间 都 在 啦	玩游戏 学习 的 时候 也 不在 
定位 明确 先 	顶 这个  根本 问题
当 个 好人 再 睡 	好人 居然 睡不着 觉  没 天理 啊 
好人 居然 睡不着 觉  没 天理 啊 	其实 我 已经 睡着 了 
其实 我 已经 睡着 了 	你现在 在 梦游 我知道
我 也 要 个 大叔 来 疼  安 	好 吧 3
好 吧 3	安 
我也是 好人 	好人 还是 多 呀
嗯  好人	欢迎 好人
欢迎 好人	嗯  谢谢
你们 猜 m 会不会 奉 子 成婚 呢 	太坏了 
你 就 得病 了	好不 了了 怎么办
武汉 上学 的 围观	我 也 素
1	为 虾米 要是 巨蟹  1
帮顶 	谢谢
要 沉 了  帮顶 	谢谢
双鱼 妹子 	是 啊
比 我 小  	小 怎么了 
好 吧 哈哈  手 很漂亮 捏	呵呵  谢谢
呵呵  谢谢	不客气
额  还 没收 啊	是 的 各种 无力 啊
让 我来 收 了 你	呃 你 愿望 是 有 多 强烈 呀 姐姐
我在 武汉   	啊哈
姐姐 来 收 了 你	你 是 有 对象 的 人 啦
好 真诚 的 感觉	可是 还没有 人 收 了 我
肿 么 不是 巨蟹 捏 	为 虾米 要是 巨蟹 
为 虾米 要是 巨蟹 	星座 控
星座 控	好 吧  真心 不是 巨蟹
好 吧  真心 不是 巨蟹	还 好啦    开玩笑 
双鱼 妹子 	恩哼恩哼
恩哼恩哼	乜  也是 水 象 星座 啊
乜  也是 水 象 星座 啊	恩呢呗    相克 么 
恩呢呗    相克 么 	不 啊
不 啊	诶  那 就好 
亲 坐标 不 给力	你 没看到 这 句 么  
应该 是 自作多情    嗷 唔	吃个饭 而已 啦
是 咩  惶恐 惶恐   	惶恐 
你 错 了 亲	那你 打算 收 了 我 咩 
what 	 
希望 别 轻易 沉 下去	我 也 不 希望 沉 下去
非诚勿扰 么 	可以 先 聊聊 呀
肿 么 不是 巨蟹 捏 	1
1	  
星座 控	嗯嗯  巨蟹 比较好 沟通
帮顶	很 感动 捏
帮顶 啦	是 我 不够 真诚 么
是 我 不够 真诚 么	木有 啊 挺 真诚 的 多大 了 额 你 
木有 啊 挺 真诚 的 多大 了 额 你 	89年 的 天蝎
嘿嘿	你 的 坐标 是
你 的 坐标 是	山西 现在 山东 上学
山西 现在 山东 上学	在 河北 两 遍 蹦 来 蹦 去
记号  明天 回来看 答案	1
我 觉得 线索 可能 在 他 的 微博 里	没有 嗷
破解 出来 就是 bazinga	求真相 求解释 求 指点   
全 键盘 手机   不知道	suretype 键盘 12 键
是什么 工作 啊 	o ( ) o 只 看到 最后 一行
是不是 音乐	啊  求解释
确实 不是 表白 啊  您 这 咋整 滴 	手机 拼音 的
没有 上下文 之类 的 提示 	没有 啊 这 是 一条 微博
要不 拉 个 微信 群	还是 算了吧
好多 男人  我 还有机会 么	他们 都 shi 了   
他们 都 shi 了   	谢谢你  我 复活 了 
谢谢你  我 复活 了 	哈哈哈
同 求	握手
蓝 着 蓝 着 就 绿 了	呃   
你 这 头像 好像 我 高中 同学 啊	你 这 眼神 很 犀利 啊
没有 呢	囧 都 蒸 了 快 一年 了 都
囧 都 蒸 了 快 一年 了 都	嗯  中间 搁置 了 一段时间
有 吗 	是 啊    现在 就 没有找到  
是 啊    现在 就 没有找到  	握手
蓝颜 就是 男 的 吗	那 该是 女 的 吗 
你看 的 很 明白 	年龄 大 了  感觉 就不 那么 天真 了
不过 你好像 经历 的 也 蛮 多 的 	其实 真心 没有  
居然 是 一年前 的	怎样 
聊 会会 很好 	聊 会会 
希望 我来 的 不算 太晚	( )
报名 一下	欢迎 踊跃报名
欢迎 踊跃报名	快 到 碗 里来
快 到 碗 里来	就 不能 找 个 大点 的 碗 嘛
就 不能 找 个 大点 的 碗 嘛	kingsize 的 喜欢 不
kingsize 的 喜欢 不	呃  
这里 这里	肿 么 了 
我可以 蛮 	怎么 大家 都 喜欢 问 这个问题
嗯 	微信 466557031
微信 466557031	回归 正常 生活  
有木有 金牛男   哈哈哈	差一点儿 金牛  认识 下 
差一点儿 金牛  认识 下 	怎么 叫 差一点 
怎么 叫 差一点 	双子
双子	哦  呵呵
(	  如何
  如何	神马 
早 碎 过去 了  	求 蓝颜大四 做 毕设 中
撒图 	你 是 河北 的 噻 
你 是 河北 的 噻 	嗯 哪
没 图说 个 撒 	撒图 
撒图 	照片 噻
其实 我在 考虑 要不要 删	蓝 言 其实 这个词 很 纠结 的
蓝 言 其实 这个词 很 纠结 的	也 没有 吧 
是 可以 还是 不可以 啊 	可以 啊  我 不是 愉悦 的 表情 吗 
要不 拉 个 微信 群	这个 可以 有 丫
高三 过 来玩 一下	高三 好好学习 吧 孩子 
对对  手机 不能 回复 很 坑爹	还 不是 一般 的 坑爹
好 吧    你们 继续 吧   	要不 你 加 个 找 闺蜜 
要不 你 加 个 找 闺蜜 	亲  你 找 闺蜜 吗
你 是 不知道 我 的 苦恼 啊	你 也 不知道 我 的 苦恼  
我 也 聊 我 也 聊	聊 神马 聊 神马
亲 这 是 让 我 公开 	好 的  就 这么 定
好 的  就 这么 定	去 死   
哦哦哦  我 听 你 的	还是 听 你 的 吧  你 是 男生 嘛
现在 几点  白 吗  	我说 你  
这 又是 什么 怪癖 啊	咋 俩 谁 怪癖 啊  没事 竟 学 动物 叫
是 啊  俺 念念不忘 额	还是 忘了 吧
天 怎么 黑 了	大白
呵呵  差不多	你 这几天 来 一下  我 都 忘却 了
你 这几天 来 一下  我 都 忘却 了	呵呵呵  是 我 的 错
呵呵呵  是 我 的 错	势必 蓝颜一多  人 就 忙 啊
势必 蓝颜一多  人 就 忙 啊	真的 没有
切切	我 不卖 切糕 哦 哈哈
我 不卖 切糕 哦 哈哈	不要 跟 我 提 切糕  我 生气
你妹 的  	诶  可以 我没有 妹 啊  太 孤苦 了
才 不	额  莫 要 傲娇  快  听话
额  莫 要 傲娇  快  听话	shi 去
( ） ） )	看来 你 蓝颜 还 真 不少
那 汪  行不行	不 行不行 不行
想听 切糕 故事 的 心理 喵	不许 喵  
什么叫 蓝颜 来着  	密友 
密友 	有 多 密 啊
有 多 密 啊	你猜
蓝 着 蓝 着  你 男 盆 友 就 绿 了   	正解  坐等 此楼 被删
要不要 这么 火  从 去年 看到 今年 	人品 好  么 办法  哈哈哈哈
你妹 的	你妹  
你 做 我 红颜  嘻嘻	呵呵
呵呵	呵呵呵   
蓝颜太 费劲	神马 不 费劲 啊
人家 羞射 嘛	你 羞射 神马 
聊 什么 	随便 聊吧
金牛男 飘过  	( ） )
15 岁 	这不 是 年龄 不是 那 啥 嘛 
这不 是 年龄 不是 那 啥 嘛 	 
哎呀  露珠 好 直接  银 家 好 羞射 	我 怎么了 
嗯	嗯 
嗯 	腹黑 一下  同时 求 58
得 仔细斟酌 斟酌 才 行 	鱼 和 熊掌 不可兼得 啊
握手	抱拳 握爪
你看 的 很 明白 	年龄 大 了  感觉 就不 那么 天真 了
不过 你好像 经历 的 也 蛮 多 的 	其实 真心 没有  
	咩
蓝颜 不是 这么 找到 的    	那 蓝颜 该 肿 么 找  传播 下 经验 啊 
蓝颜 没 红颜 好	红颜 对 你 来说 吧 
这个 要 看 缘分	同意
蓝 着 蓝 着  你 男 盆 友 就 绿 了   	1    不相信 这种
锅 我来 咯  妹 你 久等 了	(
举手	请 讲
感觉 飞信 好 遥远  	微信 已经 加 了 两个 了  就 不留 了
红颜 ok 呗 	ok
ok	qq  微信 
有 称 心意 的 出现 没 	这个 不好说
绿 了 貌似 也 不好 吧	神马 
直接 微信 漂流瓶 不 就 得了	漂流瓶 很 邪恶 好不好
蓝 着 蓝 着  你 男 盆 友 就 绿 了   	我 木 男 盆 友  谢谢 
在这里 求 蓝颜 是 有 多 寂寞 	还好 吧
河北 这么远	是 的 哇
万言 只 在 呵呵 中	  
脸红 的 可以 嘛	聊天 而已  脸 不 脸红 无关 吧
聊天 而已  脸 不 脸红 无关 吧	脸红 不是 蓝颜啊
脸红 不是 蓝颜啊	怎么说 
 	什么 问题 呀 呆 妹纸
什么 问题 呀 呆 妹纸	你 才 呆 ( )
你 才 呆 ( )	切切切 还 不承认
切切切 还 不承认	本来 也 没有
本来 也 没有	就是 就是 就是 呆
就是 就是 就是 呆	打 你 打 你 打 你  
打 你 打 你 打 你  	bulubulubulu
bulubulubulu	哼   
哼   	哼哼 
太 羞涩 不好 哈 	你 
擦	哈哈哈
我 还 喵 呢 	( )
喵   	咩
我 	你 
我 我 我	(
我 	你 要说 什么 啦
哇 咔咔  路过 看看	( )
这 是 玩 暧昧 吧  还 隔 空 的 	暧昧 不 暧昧 全 看 你 心态 了
我可以 吗	闺蜜 
我 就 看看 我 不说话	才 怪 (
才 怪 (	真的 我 就 看看 的 咯
迟 了  已经 下课 很久 了	好 吧   我 的 错  
玩 豆瓣 比 上课 好玩 多 了	还是 要 好好学习 的 哈
111	嗯 
其实 我 对 星座 没 那么 了解  	金牛男 不是 很 讨厌 吗 ( o )
金牛男 不是 很 讨厌 吗 ( o )	是 吗  我 不 认识 金牛男耶
这个 点 过来 还 赶得上 不	早 碎 过去 了  
早 碎 过去 了  	找到 蓝颜 了 没
找到 蓝颜 了 没	这 是 个 持续 长久 的 事 吧
对 的 纯粹 的 想 聊聊	哎  很难 的 说 
哟 厚  蓝颜 是 和好 角色	和好 角色 
正解  坐等 此楼 被删	大哥  你 这 什么 心里  
额 这个 帖子 都 一年多 了 唉	证明 我 是 个 有 毅力 的 人 吧  哈哈
证明 我 是 个 有 毅力 的 人 吧  哈哈	那 我来 应征 一个  唔
那 我来 应征 一个  唔	这    我 没 那么 重口   
这    我 没 那么 重口   	额 我 哪里 重 了 （ ）
额 我 哪里 重 了 （ ）	你 某 啊
你 某 啊	额 不懂 t t
额 不懂 t t	女生 之间 是 闺蜜 吧 
原来 不止 我 一个 人 啊	好 了 我 是 有 头像 的 人 了
好 了 我 是 有 头像 的 人 了	看见了  
露珠 还 蛮 清纯 的	还 蛮 
还在 找 吗 	一直 在 寻找  从来 未 间断
1024	
	一级 棒 的 意思
一级 棒 的 意思	好奇怪
说 真的	我 也 没 说 假 的 好不
懒得 勾搭	如果 我 是 你 会 懒得 看   
朋友 叫 我 大众 闺蜜 不想 啊	不喜欢 嘛 
402568407 加我 吧	这 是 一串 神马 数字 呢
潜在 扛 把子 次 噢 	好孩子   要 经常 来   
潜在 扛 把子 次 噢 	欢迎 多多 露 粗 水面    
住在 靠谱 的 豆 友家 	       我 没 豆 友
哈哈哈  您 真 有 远见 	客气 了 亲
为什么 一定要 在 二环 内 呢   	上班 近
2 环 内  北边 还是 南边	崇文
非 在 帝都 挤 我 也想 问 图 什么	其实 到 最后  人们 都 说不清 了
我 也 等	辛苦
你 听 谁 说 的	我 就 瞎猜 猜
堂堂 坏 淫         	我 坏 我 自豪 我 坏 我 骄傲
不喜欢 睡觉 啊	你 死死 外 算 的
找 时间 补 回来 啊	不喜欢 睡觉 啊
随意    结果 都一样	怎么可以 这么 随便 
我 小于 6	崇拜  牛逼 
哪儿 跟 哪儿 异地   	湖南 浙江 
曾今 异地恋  四年 异地  	现在 呢      
曾今 异地恋  四年 异地  	现在 呢   
现在 呢   	分 了  
你 说 你 么    	是 的   
湖南 浙江 	    
唉     放手 吧    	我 一直 狠狠 地 用 脚 抓 着 他   
异地  从 大一 到 现在 大三 	熬 一 熬 就 修成 正果 了    
下半年 求 合租 中南 世纪城	中南 世纪 花城 行不行 
勒 个 去  你们 数量 不 也是 2	亲 我说 最好 一个 人
亲 我说 最好 一个 人	亲 那 是 最好  可以 退 而 求 其次 的
呆呆 你敢 睡 么	我 又 不是 没 睡 过
我 又 不是 没 睡 过	哈哈 小 受受 睡 过
下半年 求 合租 中南 世纪城	借 帖子 打 广告 是 收费 的 
借 帖子 打 广告 是 收费 的 	这不 是 打 广告 是 我 想 合租
这不 是 打 广告 是 我 想 合租	你来 跟 我 租吧
你来 跟 我 租吧	离 上班 地 有点 远 了
离 上班 地 有点 远 了	恩  恩
多少钱 一个 月	550--600
你们 就是 搞基 来着  有照片 为 证	不要 逼 我 上 两女 一 男 照 啊
上 个 床 呗 	为嘛 
为嘛 	不是 容易 吗 
我 就 喜欢你 这样 的	崩溃 了 什么 心理 这 是
就 当 找 了 一次 鸭子 吧	嗯   这事  我 总算 消化 完了  
人家 二 哪 会 让 你 发现	好 吧 假设 我 不是 最 2 的
恩 那你 算算 祖国 的 温度 吧	哈哈哈  果子 好 经典 哦    
哈哈哈  果子 好 经典 哦    	半夜 臭 贫 呗
半夜 臭 贫 呗	上课 去 了  爪 机 继续 聊   
上课 去 了  爪 机 继续 聊   	华侨 保重
华侨 保重	出 个 门把 华侨 冻 了 个 半死    
出 个 门把 华侨 冻 了 个 半死    	好好 活着 祖国 人民 想念你
对 哦     勉强 有点 安慰   	还是 有 优势 3
8 错 8 错	兄弟  你 把 这个 当 聊天 帖 了 诶
我喜欢 的 也 都 有 男朋友 了	一块儿 进来 纠结 吧
有 男友 的 人 喜欢 别人 怎么办 	把持 住    实在 不行 就 换   
祖国 今天 阴天	我在 法国
恩 那你 算算 祖国 的 温度 吧	法国 我 一 放假 就 大 降温   
法国 我 一 放假 就 大 降温   	哎呀 中国 么
啊 快 天亮了	国内 才 5 点 吧
有人 去 捡 么	果断 没有   
果断 没有   	啧啧 浪费
啧啧 浪费	都是 抽 的 差不多 锝
都是 抽 的 差不多 锝	你俩 玩吧 我去 吃 早点   
你俩 玩吧 我去 吃 早点   	慢慢 吃 
在家 好无聊 哦	对啊 都 不知道 干什么  
生猛 新 生军 	神马 意思  
你 活力 过 猛   	咆哮 体 的 错          
那 就 抓紧 时间 月抛 吧 	老湿   tt
那样 是 没有 生命 的	你 想 拥有 生命 么 
你 想 拥有 生命 么 	它 在 呢 
它 在 呢 	孩子  听话  快 去 做 题 
孩子  听话  快 去 做 题 	哎  
我 不是 不知道 你 是 好 孩纸 么 	很 不 开心 好嘛
很 不 开心 好嘛	摸头 
摸头 	还是 谢谢你
还是 谢谢你	客气 了 孩子 
真相 何 用     	欣赏          
都 木有 人 聊 了 还 翻 啊啊	翻翻 聊 的 人 就 多 了
翻翻 聊 的 人 就 多 了	晚饭后 吧
是 啊 是 啊 好 的	坐等 晚饭后
快 下班 了 我来 给 咱 翻 	都 木有 人 聊 了 还 翻 啊啊
北京 孩纸 重庆 上学	肿 么 都 不对 搭 
阿哈哈 我 坚持 我 就是 小 盆宇哦 也	好 心态 mua  ( 3 )
太 空旷 了 啊 	给 个 话题  
想办法 当 上 他 闺蜜 	当 男生 闺蜜 有 技巧 可 说 吗 
yj 短小 的 男人 面对 女人 会 如何	一半 深情  一半 技巧
帮 推 了	谢谢 吖 貌似 现在 散 完了
字母 v 啊 多谢 地址 豆油	姑娘 对不起 v 已 出
把 你 地址 豆 邮 我	不用 回 片 了 你 的 地址 呢
举 爪  地址 啊 在 主页	我要 那个 字母 t
豆油 1	  
  	豆油 呢 
就是 抵挡 不住 可是 伤心	致命 的 吸引力
三年 异地恋 还 分手 	那 边儿 有 导火索 了
我 翻页 了    人生 中 第一次	哎    导火索
那 边儿 有 导火索 了	握爪  一样 的 遭遇
可是 发现 自己 不会爱 人 了	那 只能 说明 你 遇见 的 不是 对 的 人
不适合  没有 共同 话题	可是 我 和 他 总是 聊 不完 的 话
吹 了	同样 吹 了   
水瓶男 口 贩子  太 没 安全感 	口 贩子 何 意 
其实 蛮 合适 的 适合 结婚 的 那种	真的吗  真的吗  激动 啊
我 的 猎物 瓶 男 一周 我们 没 联系 了 呢	一周 没 联系     为嘛 
感觉 水瓶男 有点 轻浮 	何解 
ls 不 靠谱	同上
同上	同同 上
同同 上	猫 夫人 你
必须 真心 hold 不住 的	煎熬
分手 了	节哀  节哀
同 问  难道 只能 让 皮肤 慢慢 长 	怎么 个 慢慢 长法 啊   
连 wifi  然后 下载 数据 包	没 无线 呢  
亲  你可以 换个 小组 试试	换个 小组 就不 是 在 嘉兴 了  
二院 人民 欢迎 您	好 的  你 做 过 
差 0.3 分 的 人 笑 而 不言	握手  我 也 差 过 0.3
面试 挂 的 人 路过   	1
视力 0.1 的 人 飘过  	哈哈 哈哈哈 哈哈哈哈
函 函 咋个 牛 b 了 	前面的 楼盖 得 都 很 齐
你们 家人 的 态度 还是 很 宽松 的 啊	这 是 开始 妞儿 现在 几点 
我 现在 就 想 大哭 一 场   	怎么了 啊
兰州烧饼	不是 山东 的 烧饼 好吃 吗 
为啥 豆瓣 现在 变成 这样	变成 啥样 了  洗耳恭听
姐弟恋 ing    	best wishes
抱抱	被抢 台词 了    呜呜
异地恋 失败 的 路过	抱抱 ）
异国 的 追 出国 去 了 基佬	狠 好
	
我要 怀疑 和 你 一个 学校 了	真的 么 我们 学校 在 学院路 上
只要不 搞基 一切 都 好说	o ( ) o 哈哈
师生恋 ing   	祝幸湖  
不对  相差 八岁  我擦   	女生  
不对  相差 八岁  我擦   	亲  你 是 中学 老师 咩  
呃 跟 荷兰 男友   没 结果	抱抱 ） 
已经 分 掉 了 哎	o ( ) o 抱抱 ） ）
当然 是 大学	内部 消化 的 可能性 粉 大 哎
当然 是 大学	这样 的 老师 应该 抢手 各种   
我  异国  分 了 	抱抱 ）
人类 阻止 不了 师生恋 了   	必须的    
翻页 了	咩 哈哈  新年好  
大学 嘛  	恩  大学  
恩  大学  	姐弟恋 盛行 不衰  而且 高调 依旧 
异地恋 昨天 分手 了	抱抱
我 30 岁  我 老公 20 岁	( o ) 祝幸福 
异国 的 追 出国 去 了 基佬	最后   两个字  
dota 我 的 最爱 啊	代表 广大 女性 同胞 喷 击 dota 
我 的 大脑 是 双核 的   	双核    不 经用 了 啊
双核    不 经用 了 啊	好 吧  明天 换 i 7   
好 吧  明天 换 i 7   	衣服 洗 完 没 呐
没 明白 美剧 	
报个到 估计 很 晚睡 了	去 干嘛 撒 
有 瓶子 吗 	啥   没 懂
哟    生日快乐 	提 了 个 好多 早 d
别 我 面前 说 老人 啊      	收回 收回 该 罚 
哇 有 正 妹   	哪 哪 哪 哥们 带 我去
哪 哪 哪 哥们 带 我去	（ ） 就 在 你 lsss   
吼 瓶 男 思维 快板 啊  	解惑 贴 了  
有 瓶子 吗 	我 是 水瓶男   
时差 党进 来 凑热闹	时差 党 明天 几点 起  
这样 就 不算 熬夜 了  	对啊 现在 在 纠结 着 作业 呢
生日快乐	谢谢 o ( ) o
生日快乐 	谢谢      
破壳 日 快乐	恩  谢谢
不 认识   也 给 个 祝福 吧	祝愿 生日快乐
有 想要 在 伦敦 住 一晚 的 同学 吗 	我 想 呢
一起 挖 	一起 一起
怎么 争取 啊	默默 的 往 前 挤     
我去 喔	一起 伐    
我也是 谢村 的 一起 一起 啊	这位 同学 你 买好 票 了 吗
同在 曼城 求 组织 啊	没有 组织 建立 组织
你 打算 买 什么 价位 的 票 呀	我 估计 也 就是 58 或者 88 吧
招 实习生 吗      	暂时 不需要 实习生 哦
很不错  加油	简历 收到 否 
简历 收到 否 	你 收到 已 收到 简历 的 回复 了 吗 
你 收到 已 收到 简历 的 回复 了 吗 	没有
实习生  应届生  要么 	暂时 不需要 实习生 哦
不错 啊 不过 俺 只 会 平 媒 那一套	也 不错 
能 做 策划 的 话 可以 发 简历 一 试	已 发送  献丑 了
住宿 呢	住宿 自理 哦  
简历 已 发送  请注意 查收	好 的
要 个 实习生 好 么	暂时 不要 哦
还 缺 人 不 	缺 
不错 啊 不过 俺 只 会 平 媒 那一套	也 不错 
我 都 回 桂林 啦 你 在 哪 间 做 捏	花田错  离 西街 蛮 近 的
求 相机 是 怎么 求 来 的 	就 在 豆瓣 求 的
已 豆油	骗 纸
豆油 是什么	差 哥 不是 征 人 喝酒
人参 公鸡 戳 	我 会 一下 一下 戳 的
我 也 没有  没有 就 没有 呗	你 这 头像 让 我 很 有好感
我 也 没有  没有 就 没有 呗	太 好 了
因为你 没有 善于 发现 的 眼睛	你 有啥 爱好
西五环 穷苦 人民 飘过	没事  差 两 圈 而已  不远
木有 真相 很难 蒸 到 啊	真相 开放 了 敬请 参 赏
对不起  我爱你	同 楼上 啊  看 一次 哭 一次 
水月 洞天	这 也 能 哭   
蓝火 刀锋  真的 是 哭 死 我 了	我 只 看 了 前 几集  我 都笑 死了
49 天	真心 喜欢 49 天    
49 天	我 也 看 泪奔 了
蓝火 刀锋  真的 是 哭 死 我 了	火蓝  
奋斗	我 的 青春 谁 做主
他们 生活 的 世界	  善良 的 男人 
他们 生活 的 世界	这个 我 没 看完  后面 是 悲 么
对不起  我爱你	绝对 的 
49 天	嗯嗯  
我们 无处 安放 的 青春	最后 看 蒙蒙 那 会  哭 惨 了
我们 无处 安放 的 青春	结局 不是我 喜欢 的
对不起  我爱你	1
水月 洞天	1
49 天	1
天国 的 阶梯	这个 我 也 哭 惨 了   
蓝火 刀锋  真的 是 哭 死 我 了	亲  是 火蓝刀锋 吧
你 说 的 是 这个 吧	好像是 在 张杨路 那 附近 忘记 了
好像是 在 张杨路 那 附近 忘记 了	柴田
好像是 在 张杨路 那 附近 忘记 了	这个 也 还好
这个 也 还好	我 也 听说 这个 不错 没 那么 甜
蓝罐曲奇  送礼 体面 过人	不是 超市里 的 吧
好美 的 寓意	马卡隆 超级 超级 超级 甜
可以 考虑 从新 概念 英语 开始 	从 第一册 开始
靠谱 么	你猜 
据说 一个 月 只有 一个 名额	ok
据说 一个 月 只有 一个 名额	一个 月 一个 名额  
白羊男 	摩羯
摩羯	嗷  好 不爽
嗷  好 不爽	怎么了
白羊男 	是 的 吧
早就 把 他 t 给 那个 三 了 啊	好 吧
在这里 留言 表示 进入 游戏 吗 	是 的  另外 提问 也是 在这里
疑问 警察 可以 保护 自己 吧 	可以
这么 晚 了 还在   我 明天 看吧  	晚安
和杰 妈 不是 一组   	真 想看看 推理 帝平丸 的 水平 呢
你 这几年 是 怎么过 来 的  	你 想不想 啊 
处女座 的 吧	不 系
同 境遇	握爪   
没有 真相 算什么 	怕 碰见 熟人
有 真相 咩	羞射
前者	   这个 年龄 相当 2
   这个 年龄 相当 2	
徘徊 在 c d 之间	说什么 无 图 无 真相 的 人 都 弱爆 了
没错 我也是 这个 意思	
预计 什么 能 破 	我 也 不知道 了
能 验证 不	别
早 生 贵子	如果 可以  我 就 生 
任天堂 控 含泪 路过 	3 ds 没有 前途 了  卖 了 买 v 吧
为什么 我 的 星盘 都 贴 不上	有的 时候 上传 图片 功能 会 抽   
主要 是 月 蝎 吧	是 月 蝎  躺 中  画 圈 
可以 中和 不 代表 中和 了 	那 本来 是 哪些 造成 的 情商 低 呢 
是 月 蝎  躺 中  画 圈 	月 蝎 到底 会 怎样 啊  压抑  腹黑 
职业 消灭 零 回复	谢谢咯  不用 自己做 沙发 啦  哈哈
谢谢咯  不用 自己做 沙发 啦  哈哈	为 人民 服务
加油 啦	谢谢 我 会 加油 的
额  可以 问 下 薪资 范围 么 	2.5k-3.5k
已发 简历  您 的 qq号 不 对啊 	不好意思  qq号 留 错 了
表妹 是什么 	会 做 表 的  
我喜欢	简历 
还以为 非 要 招 国米 球迷	
住 酒店 哈 你们 多少 人	  2个  正 纠结 住 哪 附近 呢
你 几号 到 几号 	我 3月 都 在 那
一个 人 这么 潇洒	好 的 咱 豆油 说 啊
哦哦 可以 结伴 啊 到时 豆油	你 几号 出发 
你 房间 定 好 没  你们 怎么 安排 	还没有 呢 你 qq 多少 
ps 吧 赶脚 有点 用 呢	ps 哦  唉  好像 不 靠谱 啊
主要 是 兴趣 与 志向	木有 兴趣 唉
做 环评 吧  包 你 越 老 越 值钱	环评 是 撒 
小 单位 吧	我 还是 比较 轻松  国企
我 还是 比较 轻松  国企	0 那 不错
考 个 律师证 做 个 助理 神马 的 可以 么	律师证 貌似 很难 考 啊
真的 	当然 真的 啦
当然 真的 啦	你 想要 什么 礼物 呢 呵呵 豆 邮 吧
需求 刚刚好 哈哈	来吧  嘿嘿
表妹 和 表姐 本人 男	你们 家       好 乱 啊
楼上 你 害我 被 审核	哈哈 啊 好    对不住
哥们 不 搅 基 不 月抛	啥 是 月抛 
我 妈	你 妈 会不会 摸 你 
表示 还 没 裸睡 过	朋友 你 out 了
你 想 干嘛   	我 哪边 没 说明白 
专业 打酱油 的 要么	必须 要 啊 
哎   好 可惜	谢谢你 支持    么么
我 南京 的 哎 	我们 就是 需要 南京 的 哇 
没 见 着 豆油	好 吧  看见了
求 打酱油	( o ) 欢迎 
有 激情戏 不 哈哈	我们 这 正经 小清新 
那个  今天天气 不错 哈   	我擦 饭 都 不管
是 的 去 南艺 南广 找 呗	你们 说 的 好 轻巧 
你们 说 的 好 轻巧 	不过 如果 没钱 就 得 拼 人品 了
那 怎么 到 南京 了	南京 是 风水宝地 呀
南京 是 风水宝地 呀	好 吧 还是 不 去 凑 这 热闹 了
好 吧 还是 不 去 凑 这 热闹 了	怎么 个 意思 
怎么 个 意思 	怕 拍片 回来 缺 个 肾 什么 的  
怕 拍片 回来 缺 个 肾 什么 的  	我们 会 还 您 一 iphone   
我们 会 还 您 一 iphone   	觉得 诺基亚 很好 了
自个儿 有 呢 哈	必须 漂亮 啊
必须 漂亮 啊	嗯哼 哪呢 哪呢
     不是 吧	只要 上镜  一切 都 好说     
哎 摆 我 合适 蛮 哈哈	南京  来 一发 
只要 支持  一律 给 跪   	求 拍摄 时间  地点
届时 请 豆油 热情 围观 	路人甲 乙 么  
昨天 这 声音 此起彼伏 来着   	您 感觉 到 地动山摇 没 
抽 大嘴巴 的 音儿  是不是 特 好听 	好 吧 我承认 我 邪恶 了
好 吧 我承认 我 邪恶 了	您 要 听 么  脸 凑 过来 吧 
要 基友 么	我 是 攻 
我 是 攻 	我 是 兽
我要 酱油 	好 勒  您 要 几 斤 酱油 
明天 回 南京 啦	来 一发 么  妹纸 
来 一发 么  妹纸 	来吧 来吧 
来吧 来吧 	说 真的 呢  有 时间 吗 姑 凉 
你 看着办 吧 带 狗 行 么	狗狗 也 可以 加入 咩 3
来 济南 呗	你来 南京 呗 
你来 南京 呗 	火车票 食宿 误工费 你 都 报 么 亲 
火车票 食宿 误工费 你 都 报 么 亲 	自费 
自费 	拜拜
客串 可否	可以 啊  只要 您 有 时间 
现在 跟 南京 待 着 么 	没  在 杭州
没  在 杭州	那 您 单 为 这事儿 跑 过来 
我 想 做 打酱油 的	来吧  欢迎
来吧  欢迎	时间 地点  
时间 地点  	南京市区
哟 呵  外地 学校 来 南京 拍片 麽 	对 哇
对 哇	为嘛 自己 不 提供 男主 咧
大爷 说 的 真心 到位 	来 一发 
木有 坏人  我们 的 世界 都是 好人 	那 就 酱油 一个  记得 叫 上 我
那 就 酱油 一个  记得 叫 上 我	来 2斤 酱油 
来 2斤 酱油 	咩 哈哈
咩 哈哈	我 豆 邮 你 qq 哈  
阿姨 我 问 您 酱油 是 要 干嘛 的 	就是 演 个 路人甲 乙  星星 眼
就是 演 个 路人甲 乙  星星 眼	好 的 呢 管 饭 么  我 很 能 吃 哟
好 的 呢 管 饭 么  我 很 能 吃 哟	那个  今天天气 不错 哈   
那个  今天天气 不错 哈   	开 个 玩笑 的 嘛
有 需要 群众演员 不 	你 是 女生 吗
有 需要 群众演员 不 	要 啊 
大体 是 啥 内容 捏	爱情 小清新  o
偶 酱紫 的 行 咩 嘿嘿	只要你 自信  不 晕 镜头 就 成 哈 
摊手	专业 打酱油 的 要么
有 潜规则 么 亲	我 潜 了 你 了  你 给 我 什么 好处
试 我 吧  整 一个 文艺 小青年	目前 在 南京 么
哇  好想去 南京	南京 好地方 撒
摊手	酱油 是 要 干嘛 的 
我 给 你 跪 了   	我等着  来吧
摊手	什么 算 上镜 
帮顶	感谢
你们 是 啥 单位  银行 还是 外企	it 比较 累 哈
男 的 女 的 	同事 是 女 的
是 嘛真巧哈	是 真的 
是 真的 	我 没 说 不相信 你 缘分 了 么
我 没 说 不相信 你 缘分 了 么	哈 o
这个 价格 笑 而 不语   	没想到 您 也 会 如此 开心 欣慰
带 的 微距 头 	您说 的 一点 都 对
好 机器 好 成色 价格 笑 而 不语	能 让 您 如此 开心 我 也 很高兴
这 姑娘 特殊 行业	什么 是 特殊 行业
很 矫情 的 一个 妹纸	吼吼
人 都 没有了	在 呢 在 呢
你 不上 q 么 	在 呢  咋
我 算 一头  有啥 事	在 几号 楼
什么 是 特殊 行业	有 多 特殊
工作 的 ok 	来 我家 工作 吗  包 接送
来 我家 工作 吗  包 接送	什么 工作 啊 
附近 的  晚上 要 一起 饭饭 吗	哪里 呢
好 想要 哦	亲   我们 的 头像 哟
暗号 是什么 啊 	就 豆瓣 好啦
好 想要 哦	亲   我们 的 头像 哟
也 对 哦 	    还是 找 个 喜欢 的 吧
     你 觉得 你 配 不上 她 	也 没有 啊  我 觉得 我 挺好 的 啊
我 是 来看 豆 的	风采 依旧  
不是 这样 的 不是 这样 的	    咋 了   太贵 
幸福 都是 有 时限 的  	我 的 幸福 是不是 都 用 完了 啊 
我 的 幸福 是不是 都 用 完了 啊 	45角 仰望星空 吧 
你 快 夸 我 两句	你 是 一个 很 让 心动 的 女生
你 会 飞 不	会
最近 西安 冷 吗 	   恩    比 过年 冷
额    现在 应该 讨论 笑傲江湖 了	哼    
觉得 真    不知道 其他 蟹 女 如何	me too
真的 假 的 	觉得 真    不知道 其他 蟹 女 如何
后海 啊 不如 去 三里屯	三里屯 是不是 比较 乱 一点 
就是说 睡觉	睡觉 就说 睡觉  拽 什么 文言文
所以 我 就 睡着 了 	所以 你 就 挺尸 了  
所以 你 就 挺尸 了  	不是 挺尸  是 已经 尸 化 了
他 是 南方人 吧	必须 北方 额
自己 扇 自己 巴掌 	哼 
监督员 的 话 也 不听 了 啊 0-0	打 好 了 
哇  真 频繁  坐班车 还是 开车 啊 	开车 俺 住在 新泽西
开车 俺 住在 新泽西	米兔 啊啊啊啊   
korres 的 白茶	没 听 过 额 坐标 美帝 
在用 贝德玛  下次 想 尝试 大 葡萄	求 英文 名 啊 亲 
羡慕 ( w )	  其实 我 也 不算 时差 党
fresh 大豆  el 的 红石榴	红石榴 确实 有 不少 人 用 的 样子 
从 国内 带 的 资生堂 洗 颜专科 	好 有缘   
那 大 葡萄 呢   	caudalie
caudalie	多谢 
多谢 	( )
倩碧 洗脸皂 很好 用 啊	皂 类 不敢 轻易 试 啊 摊手
没有 用 德国 世家 的 吗 	字母 怎么 写 呢
字母 怎么 写 呢	dr hauschka
dr hauschka	没 见过 的 说  
这个 是 无 泡 的 么    	这个 当然 是 无 泡 的
对 的 这边 的 药妆店 有很多 露得清	记得 看到 洗澡 的 了 
坚持 在 skii 的 阵地上	神仙水 貌似 不错 很 想试试 
纹身 影响 找工作 吗  我 也想 纹	看 你 找 什么 工作 了
贴 猪皮	哈哈哈 哈哈哈哈 戳 中 我 笑点
你 说 你 保证 会 激光 除去	我说 了
	没什么 心思  
黑 低端 黑	难道 那个 不是 配角 么
难道 那个 不是 配角 么	
说明 没 被 潜 过	   她   真 被 潜 过  
   她   真 被 潜 过  	    
    	真的
真的	爆 一下 啊 亲 
绿茶 里 的 对手 姜文 倒地 中枪	恩 绿茶 算 演员
把 你 名字 倒 过来	伦巴 王 知道 是 干嘛 的 吗
t t  腻歪 人  走 了  回见	走 哪 7 嗦 完 我 跑 了 桑
把 你 名字 倒 过来	找乐 哈
我 不 装 力 嗨 点 你 不 欺负 我 死 我	出息 忒 大 了
出息 忒 大 了	就 乎 四 吧    
多 可恨    倒霉 孩子	哈哈哈哈
哈哈哈哈	你 不碎 觉 吗
微博 看过 这个名字 很 眼熟	我 微博 也 叫 伦巴 王 啊   
我 微博 也 叫 伦巴 王 啊   	所以说 眼熟 呀    
所以说 眼熟 呀    	你 叫 吗 呀
你 叫 吗 呀	你 是 内个 邻居 大哥 头像 么 
你 是 内个 邻居 大哥 头像 么 	没错 呀 就 我
没错 呀 就 我	那 就是了 哈哈
那 就是了 哈哈	你 是 我 粉丝 吗   
你 是 我 粉丝 吗   	并不是  在 间接 艾特里 见过 
   我 介 不 矜持 么 	我 加 你 行 吗
我 加 你 行 吗	关注 完毕
关注 完毕	收到
就 乎 四 吧    	真男人 都 这样
鼠标 都 不止 五分钟	嘿嘿 
可以 话 私 聊 给 下 qq  谢谢	我 豆油 你 了
会 肿 好久	拔 完 肿 么  
拔 完 肿 么  	一般来说 会 肿 的
没 心情  你们 扯 把 	你 也 还是 学生 不 
海瓜子	会 吃 好 嘴
鸭肠	就是 有些 有点儿 老嚼 不动
哎呀  当时 要是 早知道 就好 了	还有 吊兰 哦
范二吧	太难 了
会 有 猫步 的 女人才 会 有 狗 男人 跟着	猫步 走 不 来 啊 亲
已 存在 的 都是 正常 路线	o ( ) o
总之 是 非正常 路线 	正常 路线 的 没人 鸟
暹罗    爱 死了	呵呵 是 只 被 我 宠坏 的 胖子 了 哎
给 我 画画 嘛  	来 啊 
这不 就是 陌陌 么	的确 很像 多了点 儿 功能 
的确 很像 多了点 儿 功能 	陌陌 最新版 好像 这些 功能 也 都 有 了
me too    	me too too
来 一个	恩恩
打麻将 么	不是 看电影
要 干 啥 啊	看电影 啊
进 可 攻  退 可受 的 上 吧	哈哈哈哈 自 攻 自 受 的 最佳
哈哈哈哈 自 攻 自 受 的 最佳	理解 为 自作自受 么 亲
1 vs 3  经典 战役	有 三个 女生   
有 三个 女生   	哦  理会 错 了  原来 是 3 vs 3
哦  理会 错 了  原来 是 3 vs 3	额   这会 正解 了
报名 报名	先 排队
现在 么  	明天 晚上
年龄 多大 	29
还是 搞基 好 直男 没 市场 啊	    摊手
什么 电影 呢 	还 没 定
还 没 定	最近 也 没啥 好片
你看 我行 么  	受 还是 攻 
受 还是 攻 	可受 可 攻
可受 可 攻	额     不像
额     不像	人 不可 貌相
明天 晚上	请客 么 
请客 么 	不 请客 aa
么 瞧 明白 干嘛	找 个 二次元 的 三个 童鞋 一起 看电影
来了 月 之	月 之 是什么 意思
月 之 是什么 意思	换个 字  约
连 看 3 场 呗	看一场 6个 人 一起
小受 小攻 什么 意思	真纯洁
关注 有何 用	1
某人 不是 嫌 它 吵 么  	说不定 有人喜欢
哇  我 完全 没 概念 	你 就 只 记得 吃 你 还记得 啥 
期待 继续 更新	你 也 可以 补充 一下 嘛   盘子君 
礼拜天 去 吃 呵呵 后	哦   去 吧
啥 东西 不敢 吃 	挺 多 的   杂 7 杂 8 的 都 不吃 
在 我 眼里  不吃 的 就是 杂七杂八 	囧
不喜欢 骗人家 不好意思 	尼玛  你 还会 对 我 不好意思  
尼玛  你 还会 对 我 不好意思  	当然 会 
我 对 你好 吧	好无聊 摸摸 
sundance 是 在哪里 啦 	轮渡 第一 码头  关西 楼下
人家 可能 卖 你 是 存货	是因为 看 你 比较 萌 呆 咩  哇哈哈 
是因为 看 你 比较 萌 呆 咩  哇哈哈 	谁 萌  谁知道 
谁 萌  谁知道 	想看看 周四 要 吃什么 啦
汉堡王 的 布朗尼	布朗尼 是 啥   求 科普 
下班 沉默 症	哈哈哈  没 那么 早 下班 的 啦 
你 上班 了  这么快 	之前 啦 不过 我 明天 要 面试
我在 上海  可以 帮 什么 吗	上海机场 离 火车站 远 么 
刘总  benson 董事长 找 您 	干 啥  山庄 经营 的 不是 挺好 么 
注意 硬度 就 行	比如  紫水晶 跟 石榴石 可以 么 
完全 木 问题	真 得 啊  感冒 袅  找 你们 啊
我要  	你 豆油 我 你 的 联系方式 阿  
我要          	豆油 我   
我 笑 了	哈哈
昏 手 快乐	我喜欢 这个 词语 的 说   
啥 地方	肯村   
london 的 约 一下 吧  哈哈	伦敦 好 远 的 说   
囧瑟夫 那 集 是不是 有的  	我记得 有
尺码 够 大 捐给 我 吧    哈	貌似 没有 够 大 的
我 多想 失业 啊   	不 带 这样 傲娇 的     
好多人 啊	你 也 加入我们 呀
你 也 加入我们 呀	怎么 加入 啊  
怎么 加入 啊  	一起 聊天 呗 马上 下班 咯
一起 聊天 呗 马上 下班 咯	哦 可是 看 的 有点 糊涂 的 了   
哦 可是 看 的 有点 糊涂 的 了   	就是 随便 聊聊 嘛
就是 随便 聊聊 嘛	蒽 
大家 都 在 趴 着 睡觉  哇哈哈	别 睡 了 开工 咯 加速 前进 
啦啦啦  我来 鸟	亲   你 才 来   等 的 我 好 苦 啊
你 甭 理 他  还 自作多情 了 呢	就是 呢    没 见过 这样儿 的
就是 呢    没 见过 这样儿 的	咱 聊 咱 的  甭 理 他
咱 聊 咱 的  甭 理 他	嘿嘿    今天 还 烦躁 阿 
米有哇  烦人 啊	起码 可以 调休 吧 
起码 可以 调休 吧 	5555
就 知道 哈哈	嘿嘿
我也是 哭	不哭 不哭 下班 鸟
不哭 不哭 下班 鸟	我要 5 30 呢
本来 老外 就是 没 人性	我来 鸟
最近 最 热衷 的 就是 泡吧	额  这 算是 好事 还是 坏事 呢
鱼  你 酒量 很好 么	还 好啦
我 一直 很 懒 哈哈	又是 共性 哈哈哈
又是 共性 哈哈哈	鱼  你 睡醒 了 啊
为 么 只能 看着	不敢 染指 外国 男人
不是 这 周 就是 下周 我要 出去玩 一下	去哪里 呀
回去 休息 吧   身体 要紧 啊 	浑身 发冷  怎么回事
浑身 发冷  怎么回事	受凉 了 弄 点 姜茶 喝喝
我也是 哎  最近 比 以前 强 了	年纪 大 了 就不 长 了
年纪 大 了 就不 长 了	是 么  那 要 多大 啊  我 还 想 嫁人 呢
是 么  那 要 多大 啊  我 还 想 嫁人 呢	我 也 不知道 我 也 要 嫁人 呢
嘿嘿    直接 看电影 去 了  	鱼 鱼鱼 我来 鸟
鱼 鱼鱼 我来 鸟	想死 我 了     讨厌你
想死 我 了     讨厌你	这 两天 很 忙 丫 放假了 没
赶紧 找  周围 有 合适 的 没	木有    怨念
木有    怨念	额  那 就 找人 去  相亲
额  那 就 找人 去  相亲	不要 嘛    相亲 太 坑爹 了
不要 嘛    相亲 太 坑爹 了	鱼鱼  上班 鸟
鱼鱼  上班 鸟	今天 忙 啊 
今天 忙 啊 	不是 很 忙  有 活 也 不想 干
不是 很 忙  有 活 也 不想 干	烦心事 一堆    
烦心事 一堆    	怎么啦  心情不好 么
这 周 5 天 我有 2 天都 是 提前 跑 的	哈哈 我 太 嚣张 了
鱼  我来 鸟	嘿嘿   今天 你 看来 不 忙 啊  花儿
其实 我 是 很 没有 上进心 的 人 呀	我 也 米 有  嘎嘎
我 也 米 有  嘎嘎	花儿 你们 那 平均工资 是 有 多少 阿
没用 的   还是 会 再犯 同样 的 错误	不要 这样子 嘛  呜呜
那 希望 赶紧 遇到  呜呜	会 有福 的
会 有福 的	鱼鱼  上班 鸟
恩 啊    估计 做梦 这个 是 没法 了	不 胡思乱想 啊
受不鸟 我 是 离 她 远远 的	咱 自己 玩  不理 他 嘎嘎
咱 自己 玩  不理 他 嘎嘎	嗯 呢   你 睡 过 午觉 了 已经 
我 一直 是 你 吃货 呜呜	不用 减 了   我 反正是 享乐主义 的
我努力  少吃	嗯嗯   加油 花儿
你 忘记 问 他 身上 所有 的 钱 是 多少钱	哈哈  很少 么 
心情 突然 好 差 啊	亲 怎么啦 
我 最近 觉得 啥 都 不 顺 烦死了	肯定 是因为 天气 不好
肯定 是因为 天气 不好	可 我们 这 最近 天气 好 的 不得了
是 咩 今天 心情 冷 好	求 推荐 好久 没看到 好书 了
求 推荐 好久 没看到 好书 了	额  卡耐基 的
额  卡耐基 的	我 看过 的   
我 看过 的   	乌拉拉 拉 你 今天 很 忙 么
你 午觉 醒了 咩 	醒了 啊  嘿嘿
醒了 啊  嘿嘿	花儿 你 是 做什么 工作 的 
说不定 哪天 你 也 会 闪婚	鱼  你 觉得 咱们 会 闪婚 么
鱼  你 觉得 咱们 会 闪婚 么	早 啊  花儿 我 会 的   真的
天 还 没 好 还是 冷 啊	恩  再 等等 看
我 现在 也是 但是 就是 想 出去	去 婺源 看 油菜花
去 婺源 看 油菜花	哇哈哈 马上 要 下班 鸟
嗯嗯   晚上去 嗨皮 下 亲亲	恩恩 狠狠 开心
额  我 一会 准备 提前 跑	要 跳槽 吗
我 也想 跳	咱 一起 挖
咱 一起 挖	嗯 呢
嗯 呢	鱼儿  在 不
鱼儿  在 不	在 呢 在 呢   昨天 面试 怎么样
等 下班   煎熬	下班 鸟  闪人 鸟
今天 不会 只有 我自己 上班 吧	你 加班 的 哈 
你 加班 的 哈 	嘎嘎  你 来啦
估计 悬	啊 可惜 了 
加油加油  我 给 你 祈祷	恩  谢谢 昨天 上 哪玩 去 啦 
快 了 快 了  嘿嘿	你 比 我 更 早 呀  哈哈
你 比 我 更 早 呀  哈哈	睡醒 了
睡醒 了	你 还 真是 有 规律 的 生活 呢
话说 我 昨天 晚上 2 点钟 才 睡觉	你 在 干嘛 呀
没用  净 想 些 有的 没 的	真 郁闷
真 郁闷	性格 改 不了 了 只能 接受 阿
鱼  我来 鸟	嘿嘿   周末 怎么样
你 真 幸福   我 还有 一会 折磨 呢	上班 鸟
鱼  我 英勇 的 回来 啦 哈哈	怎么样   说 你 哒 
爽 死了    现在 盼 下班 呀  	乌拉拉  坐等 啊  
乌拉拉  坐等 啊  	还有 一小 会儿
我去 喝 了 杯 咖啡	那 我去 喝 杯 白开水  咕噜咕噜
那 我去 喝 杯 白开水  咕噜咕噜	多喝水 阿 抗氧化 阿
鱼  我来 鸟	才 来 才 来    你 忙 呐
恩  下午 时间 好 长 啊  还 困 得 要命	到 了 四 点钟 就 饿 了 还
到 了 四 点钟 就 饿 了 还	吃饱了  开始 犯困
大家 都 在 趴 着 睡觉  哇哈哈	趴 着 睡觉 会 留 口水 的   哈哈
趴 着 睡觉 会 留 口水 的   哈哈	哈哈  米 事 米 事  别人 看不见 滴
不错不错  赶 在 最后 一天 啦  哈哈	你 呢  也 双鱼 啊 
你 呢  也 双鱼 啊 	恩 啊  3.2 的  呼呼
恩 啊  3.2 的  呼呼	你 工作 是什么 呀  怎么 也 无聊 呢
浮躁 还会 春心萌动	这个 承认  嘎嘎
你 也是 女人 啊 	我说 的 是 生活 方式 啊 亲
无聊 啊 空虚 啊 挠 墙 啊	没办法 缘分 未 到 阿
哈哈 大家 早	早 哈
大家好 zzzzzzz	我 也 来啦 今天 周五拉
我 也 来啦 今天 周五拉	好开心 啊
食堂 的 饭 真心 难吃	比 我买土豆粉 吃 卫生 多 了
安慰 神马 的 已经 没 多大 用 了	悲剧 啥 啊 挺好 的 么 你 都 hr 了
别 这么说 有 刺痛 感	刺痛 什么 呀 现实 阿
恩 所以 嘛 很 悲催 的 感觉	你 也 拿 她 当 你 的 一个 选择 呗
你 也 拿 她 当 你 的 一个 选择 呗	额     好 吧
额     好 吧	这样 也 可以 心理 平衡 一点 阿
好 吧 面试 结束 爬 楼 结束	怎么样  我 的 同行 对 你 和蔼 不
周末 准备 干点 什么	没事 阿 没人 陪我 玩儿
恩同 无聊	嘿嘿   情人节 怎么过 的 啊 
我 也 好无聊 呵呵	聊聊天 呗
哈哈  天天 有 桃花  	刺激 人 呢
你们 都是 很 双鱼座 的 	我 双鱼 啊
我 想 买 防毒面具 	多种 几 盆 绿萝  水培 就 行
多种 几 盆 绿萝  水培 就 行	恩 有 建设性 值得 考虑
额 ls 什么 星座 啊	秤 女   
早 打扫 卫生 很 花 时间 啊	还要 自己 打扫 卫生 呐 
恩 眼睛 好 酸	因为 今天 是 周末 期待值 提高 了
因为 今天 是 周末 期待值 提高 了	也 没什么 期待 反正 就 宅 了
也 没什么 期待 反正 就 宅 了	休息 的 感觉 是 无法 替代 的
偶 不 觉得 我最爱 睡觉 了	矛盾
我 最近 遇到 好多 鱼 男 阿	这 说明 什么 昨天 请假 了
女同学 啊  找 机会 弄死 她 啊 	怎么 弄 啊    我 心眼 坏 不 起来
怎么 弄 啊    我 心眼 坏 不 起来	人 都会 犯错误 的
人 都会 犯错误 的	算了    她 不 害我 就是 好事 了
算了    她 不 害我 就是 好事 了	她 今天 怎么 把 你 搞 生气 了 
她 今天 怎么 把 你 搞 生气 了 	就是说 瞎话
就是说 瞎话	她 眼神 咋 了 
唉    我们 这 太阳 出来 好几天 勒	我 现在 睡  传来 吧 
我 现在 睡  传来 吧 	睡吧 睡吧
我 也 不会 打麻将	神马 叫 德国 的 网络
谈话  1 对 1 还是 1 对 多 	1 对 1 的   
1 对 1 的   	被 关注 了 
被 关注 了 	没有 拉   做事情 的   
早	good morning
good morning	早上 又 忙 了 
苦逼 的 我 要去 开会	等 下 我 也 要去 开会
等 下 我 也 要去 开会	浪费时间 浪费 生命 啊
浪费时间 浪费 生命 啊	不过 已经 结束了
下午 又要 外出 跑腿   郁闷 呢	跑 完 腿 应该 就 可以直接 回家了 嘛
不要 睡 的 不舒服  情愿 不 睡	好 吧 我 倒是 真 想睡 一会儿
好 吧 我 倒是 真 想睡 一会儿	你 不是 睡 过 了 吗
她 自己 的 问题  对 谁 都 耍心眼	那 果断 88 啊 多 没劲
那 果断 88 啊 多 没劲	不 跟 这种 人生气
那 就 躲 他远点吧 没办法	直接 不理 她 了
直接 不理 她 了	有兴趣 解释 一下 是什么 情况 咩 
tat 压力大 死了	哈哈 那你 跟 他们 培养 感情 啊
你们 是 私营 的 公司 	私营 小企业
转正 了    在 这 有 大 半年 了	有 所谓 半年 奖 这样 的 东西 咩 
有 所谓 半年 奖 这样 的 东西 咩 	木有   就是 去年 的 年终奖 呗
木有   就是 去年 的 年终奖 呗	好 吧 有 比 没有 好 啊 orz
好 吧 有 比 没有 好 啊 orz	我 忍 我 忍
嗯   回家 就 睡觉  哈哈 	明天见 吧
去哪里 看 啊 	不知道 呢
少女 的 脸  大妈 的 心	起码 能 看 啊 噗
起码 能 看 啊 噗	那当然
那当然	睡 了 一小 会儿
睡 了 一小 会儿	好 困    眼睛 酸
哈哈   他 是 boss	啊 咧  弃 楼 不是 乃 的 风格 吧 应该
啊 咧  弃 楼 不是 乃 的 风格 吧 应该	今天 忙 死了    头 都 昏 了
哈哈   你来 啊 你来 啊	岂可 修 
恩    哈哈    	今天 不 忙 么 
悲剧 死 还 不吃饭 	马上去    我 腰酸 死了 哎
马上去    我 腰酸 死了 哎	呃 亲戚 来了 
呃 果然 是 算了 慧剑 斩 	果然 什么 啊
果然 什么 啊	和 慧剑 斩 的 那 玩意儿 有关系
这会儿 想 的 这么简单	就是 简单   
就是 简单   	好好 保持 吧
好好 保持 吧	咱 说 点 别的 话 啵
早 啊	早 神奇 的 周一 开始 了 
很开心 啊   哈哈哈	求 细节 舒缓 情绪
嗯嗯 多好 什么 花 啊 	玫瑰 咯   哈哈
玫瑰 咯   哈哈	啧啧啧 真棒
你 还 挺 淡定 的 嘛  	( ) 好习惯
( ) 好习惯	恩 周末 怎么过 的 阿
很多 网站 都 可以 排 星盘 的 啊	不会 怕 麻烦
不会 怕 麻烦	囧 五分钟 就 可以 了 应该
囧 五分钟 就 可以 了 应该	真的 很 懒 阿   亲
真的 很 懒 阿   亲	差评
差评	不要 嘛  
哈哈   他 是 boss	他 自己 也 要 扣钱 的 真是 服 了
我 一般 都会 睡 到 下午    	几点 睡
最好 这样	嗯哼 下班 周末愉快
唉    你 想办法 让 我 淡定点 哈	呃 干脆 把 自己 弄 感冒 吧
呃 干脆 把 自己 弄 感冒 吧	感冒   
不说话 不是 会 很 尴尬 吗  	所以 我说 嫑 怕 尴尬 啊
我 这 是 又 当 军师 了 么 	你 经常 当 军师 吗
几 瓶 啤酒  大 的 那种	不知道 哎   
看 情况 呢   要 看我 跟 什么 人 喝 呀	那么 极限 
晚上 又 有 饭 吃    嗨皮 阿	喝酒 咩 
闭关 修炼 吧 	吃 撑 了 昨天
你 又 不是 荒 和 墟	我不想 做梦 阿   
雪女 小鱼 关注 你好久 了	怎么 咯   怪 吓人 的
您 是 在 哪 上班 啊	沈阳  
沈阳  	为什么 没 几个 活人   
可是 她 消失了	为 么 消失了  你俩 吵架 啦
浪费 青春	拉 我们 去 凑 人数 的
0..0	怎样 
我 也 无聊 啊   	工作 很 无聊 啊 
工作 很 无聊 啊 	实习 很 无聊 啊    灰 常 的 无聊 啊
实习 很 无聊 啊    灰 常 的 无聊 啊	实习 什么 的 阿 
实习 什么 的 阿 	就是 混混 啊  等 下班
就是 混混 啊  等 下班	有 工资 啊 
有 工资 啊 	木有 工资  管顿饭   
吃 的 饱  恩恩	大四 实习 还是 什么
大四 实习 还是 什么	大四 实习 咯
大四 实习 咯	好 怀念 大四 阿
做 神马 工作 的 呀 	hr  德企  你 呢
太 对了 你 是 双鱼 的 	哦 不是 啊 蝎子 男 一只
哦 不是 啊 蝎子 男 一只	嘿嘿  我喜欢
我 也想 追 条 鱼 呢   	追 呗    你 遇到 过鱼 吗 
我 觉得 鱼 女 都 爱 睡 哎	还 爱 做梦 吓人 呢
擦 我 悲催 的 表示 米 有	我 也 没有 哈哈
我来了 眼睛 被 熏 的 疼	你 最近 很 忙 哦   好久 没 来 咧
貌似 是 射阳 的 我 就 在 宁波 啊	哦    骗 我 过去
下班 了 白白啦	周末愉快 阿
工作 的 本质   	要是 不 工作会 很 空虚 的
我 想 追 射手 呢	有 对象 了  你 双鱼 
有 对象 了  你 双鱼 	是 呀 我 是 鱼 射手 离 我 很远 啊
德企	嘎嘎 不错 啊
嘎嘎 不错 啊	不好 讨厌 老外
那 就 我 跟 她 一样 咯 	我也是 啊
我也是 啊	哈哈哈 都 凑 一块 了
我 想 买 防毒面具 	哈哈哈 绝对 有必要  
似乎 hr 中 很多 都是 双鱼座 	是 呢 你 也是 
嗯  现在 午睡 了	现在 的 小孩子 可不好 伺候 了
现在 的 小孩子 可不好 伺候 了	是 呀  很 早熟
我也是  天 真可爱 的 才 好玩 	我 对 小孩子 没有 耐心
我 对 小孩子 没有 耐心	没办法  做 这个 没 耐心 也 要 有 
呀  该 去 吃饭 了  	现在 就 吃饭  这么早 
现在 就 吃饭  这么早 	幼儿园 嘛   嘻 
幼儿园 嘛   嘻 	额   幼师  都 很 有爱
能 不 版聊 吗 版聊 还要 打 网页	那 要 怎么 聊 阿  qq 用 不了
嘿嘿    工作 是 做什么 的 呀	水利 工程师
水利 工程师	水利 工程师 是 干吗 的  大禹治水 
上班 真 无聊  还是 有 阳光 好点	你 做什么 工作 的 呀
你 做什么 工作 的 呀	那 要 看 是 说 的 好听 还是 不好听 了
那 要 看 是 说 的 好听 还是 不好听 了	说说看
说说看	好听 就叫 设计  蛋疼 点 的 叫 改图
好听 就叫 设计  蛋疼 点 的 叫 改图	改 什么 图阿  那你 会 画画 咯
改 什么 图阿  那你 会 画画 咯	哈哈哈  会 啊
哈哈哈  会 啊	我 好羡慕 会 画画 的 人 喏
他 像 你 哥  这 人 多大 啊 	81年 射手 男
81年 射手 男	富二代    伤不起
双元路	很 近 呢 我在 钱江 方舟
呵呵   今天 我 都 跑 一天 了	晚上 哈里森  他们 都 去
晚上 哈里森  他们 都 去	你 去 啊 
比如 咧  豆友聚会 有没有 拍照 	豆 友聚 会 真好 啊
不 回应 就是 没反应 了	是 啊
来 聊天 撒	来 撒
来 撒	聊 什么 撒 
聊 什么 撒 	随便 找 个 话题 聊聊 呗
随便 找 个 话题 聊聊 呗	ok 私 聊吧 注意 豆油
星期一 的 早上 就 这么 苦闷    	是 啊    不 顺 有点 泄气 了
呵呵 求 推荐 活动 	能 有 神马 活动 阿  闲 聊聊 呗
该 吃饭 了 	还有 15 分钟 才能 吃饭   
你 的 发言 太短 啦  再 多 写 几 句 吧	已经 加 了 好多个 句号 了
还好  不会 很 冷	刚 去 了 回来 吗
刚 去 了 回来 吗	春节前 去 了
中等 装	那 就 够了
戳 到 笑点	点 到 即 止  见好就收
深圳 稳 食 都 好 艰难	深圳 系 抢 食  稳 已经 系 稳 唔 到 食 啦
5 l 怎么看	5 l 会 看 1 l 怎么 问
嗯哼 	我要 名牌 滴    嗯哼   
我要 名牌 滴    嗯哼   	嗯哼 
布局 	请 赐教
简单 有效 之 攻略 直接 推倒 	靠谱 点 的
我 刚看完 你 男友 的 帖子   	那你 说 他 是不是 很 过分 
那你 说 他 是不是 很 过分 	我 觉 你们 很 般配 的   
给你们 一 箱  你们 分手吧	这 不单单 是 一 瓶 果粒橙 的 问题
一分钟 哇   	恩 1 分钟  但是 真心 很 干  
逃跑  彭坦  反光镜	一样
万青 南无 耳光 庙	大爱 耳光 啊 哈哈
万青 痛痒 扭 机	痛仰
反光镜 来  已经 有 预售票 了	刚刚 也 突然 看到 啦  微博 预售 么
你 是 男 的 还是 女 的       	男 的
等 它 长 好 吧    	什么 意思 啊   怎样 算 长 好 呢 
你 还好 么  	哈哈哈  
后悔 了 吧 	办 点 后悔 的 意思 也 没有  好 么
办 点 后悔 的 意思 也 没有  好 么	那么 你 是 来 发帖 再 找 一个 嘛 
不 转移   你 有 什么 想要 了解 的 	没有 
你 很 善良	突然 想想 我 也有 哎
我也是 啦啦啦啦啦	握爪 
咬 掉 一块 肉 	要 嚼 碎 吞 下去 吗
我 也 会 终生 难忘 的 tt	要 的 就是 这个 效果  哇 咔咔
烫 个 北斗七星 图 什么 的 出来	烫 朵 花儿
你 给 他 拔 个 火罐 不 就 成了 	会 消 的 啊 亲
会 消 的 啊 亲	那你 就 需要 搞 点 狠 的 啦 
拿 把 双立人  在 他 身上 刻 个 字	求 科普    神马 是 双立人  
指甲 磨 尖 了  上 吧 孩子	灭 有 一点点 指甲
那 只能 给 他 一刀 了	那多 不和谐
神奇 的 菇 凉 不小心 路过   	不知道 你 神奇 在哪里
不知道 你 神奇 在哪里	勇毅 鉴定 居家 放荡 才华 傲气
勇毅 鉴定 居家 放荡 才华 傲气	勇毅 鉴定  怎么 理解 呢 
勇毅 鉴定  怎么 理解 呢 	坚定  咩 哈哈
想 得美	哈哈  是 你 想 的 吧
你 戴眼镜 	不 戴
嗯哼  您 没 瞧见   	我 是 苏格拉弟  不是 苏格拉底
哈哈  咋 算 神奇 	你 认为 呢
大片 呀	谢谢
会 有的	谢谢
去 中国 黄山  住 小镇 青旅 	我不在 小镇  就 在 去 小镇 的 路上
你 被 囚禁 了 么 	没有 啊  就是 很 单纯 的 不想 上班 
传说 中 的 软广告 	好 软          
哎  不该 是 种姓 强韧 么	译著 如此
不错  创意 很好  体验 很好	多谢 鼓励 
转角 遇到 爱	恩  恩 
呵呵呵呵  你 很可爱 	这     谢谢你    
希望 你 成功 咯  天蝎 男 很好 呢	谢谢
小 天蝎 不喜欢 你	好 吧  那 我 退 散 了 
六级 三 次 都 考 了 408	点儿 背
发 了 邮件 没有 回应	每周 只有 一 场 
现在 还 招人 么  	一直 在 招 ing 
up 	现在 还在 招 的 对 么  我去 投简历 
现在 还在 招 的 对 么  我去 投简历 	对 的  还 招 的 
现在 还 招人 吗 	还在 招 中 
邮件 显示 邮箱 不 正确 已 豆 邮	邮箱 应该 没问题 
你 再发 我 一次 吧	好 的  请查收 哦
0014 怎么办	带 个 破碗 上街 吧   呵呵
那晚 在 芙蓉中路 也有 一 场 的	一般人 进 不 去
遥想 小学 六年级   	战友 握手   
战友 握手   	十几 年 的 坚守 啊   
只好 我来 挽尊 了   	还是 自己人 亲 啊 哈哈哈
唷  我 好 来 阀  啊哈哈 	请 你 毕业 之后 再来 找 我
什么 是 爱 	信任  忠诚  理解 
信任  忠诚  理解 	养 个 宠物 就能 绝对 满足 前 2条 
养 个 宠物 就能 绝对 满足 前 2条 	蒽  人 只 高明 那么 一点点 
只有 好 基友 不 离 也 不 弃	噗
我 合肥 念书 杭州 工作	你 对 两个 城市 有 什么 看法
杭州 是 很 危险 滴  你 还是 回去吧	no  哪里 危险 了
no  哪里 危险 了	花花世界 中  危机四伏 啊
花花世界 中  危机四伏 啊	花花世界  哪里 都 危险
合肥 吧	理由
我不懂	来 说 想 我 快 
我知道 是 谁  名字 三个 字  得 四 	刚好 不是
刚好 不是	擦  难道 是 你 
擦  难道 是 你 	我是谁  谁是我 
要是 人 不错 你 就 考虑 考虑 	他 是 故意 来 黑 我 的  呵呵 
我 回家 看看  爪 机	
	啊 看过 这个 了  还 打 广告  真敬业
啊 看过 这个 了  还 打 广告  真敬业	笑起来    
这 是 有 技术 的 人 	必须      
捏 线 内 段 太 帅气 了	淫 家 内 是 厂里 配 的 车
为什么 我 感觉 是 假 的	真真儿 的
卡带 老迈 	答对 了
大学 时光 不 就是 拿来 荒废 的 吗  	我 不 这么 认为 
你好 坦白    你 是 it 族 	我 是 个 画画 的
就是 找 一 聊天 的 呗	恩  基本上 就是 这个 意思 
你好 坦白    你 是 it 族 	虽然 显示 是 我 养活 画画
maybe 通吃 	我 想 去 峨眉山 看 师太 啊啊
找人 陪 你们 打麻将 	呵呵 我 不 打麻将 的
生日快乐  不要 难过  勇敢 向前 看	谢谢 真好  我 会 的 
呵呵 抽 醒 我 吧 哈哈哈	我 可 舍不得 抽 你  哈哈  
真的好 美	）
哎呦  海上皇宫 现在 还是 餐厅 吗 	早已 荒废 多年 
早已 荒废 多年 	这不 是 还 亮 灯 的 嘛
哎呦  海上皇宫 现在 还是 餐厅 吗 	鬼屋 
i love you  吐	求 合体
射手 男	还有 狮子 和 白羊
快要 半百 了 都 	身材 和 气质 都 不像 
酒香 不怕 巷子 深	酒干倘卖无
你 又 活跃 了	是 的 吖   
真 小资	要 的 就是 小资 范
西瓜 小姐 懂 好多 哦	我 就 焉 了  
我 就 焉 了  	吼吼
西瓜 小姐 是 学 这个 专业 的 	你 是 要 考 这个 么  还是 怎样 的 说
女生 速度 哟 mm 有 惊喜 哦	惊喜 在哪里
莲花	握爪    
秘密	我 也 在 看 这本书 咯
课后 习题 解答	这个 真 经典
课后 习题 解答	此 沙发 已然 无法 超越 
追风筝的人	这个 醍醐灌顶 了 好 特别
课后 习题 解答	哈哈 哈哈哈 哈哈哈哈
蒙田 是 个 潮人 啊	是 啊  无忧无虑 的 小清新
百年 孤独  假期 刚 看 的 	握握手
课后 习题 解答	哈哈 哈哈哈 哎 妈呀 笑死 我 了
课后 习题 解答	差点 噎 死 一 楼 犀利 爆 了
秘密	1
课后 习题 解答	哈哈 哈哈哈哈
课后 习题 解答	哈哈 哈哈哈哈 哈哈哈哈
课后 习题 解答	哈哈 哈哈哈
是 有 部 电影 叫 闰年 的 吧	爱尔兰 一个 美好 的 传说
我 不 建议 我们 互相 折磨 一下 的	你 是 红人  不敢 折磨 你   
唯有 恋 得 短暂  才能 爱 得 永恒 	说 得 好  有些 爱情 不该 来 的 太早 
握爪  同 悲催 的 人	我 也 喜欢 莫然  握爪
爱尔兰 一个 美好 的 传说	你 又 不 睡 是 吧
我喜欢 的 男人 已经 有 女人 了 	哥 没有 挡 着 你 的 视线 吧 
我 也 喜欢 莫然  握爪	我 不喜欢 移情 别恋 的 人
握爪  同 悲催 的 人	你 也 喜欢 莫然 
因为我 是 奇怪 的 蝎子	残疾人 就是这样
这种 好似 幻觉 的 永恒 最 痛	再说 我 就 痛 了
经常 被 僵尸 追 的 飘过	握爪 之
念慈庵 的 批把 膏	吃 了  无效  叹气 
甘草片 咩	等 我 试试  谢谢 
男 的 女 的 	男 的
多少钱 啊	600
我们 都 可以 拼 国际 运费 了  	一起 一起 哈哈
没 碰到 四娘粉 就 不错 了	真 要是 四娘粉 也 不会 跟 我有 交集
你们 看 不看 another 的	你 在 他乡 还好 吗 
你 在 他乡 还好 吗 	不大好   谢谢 关心
不大好   谢谢 关心	再 2个 月 就 放假了 吧  加油
朵拉 看样子 是 电影 皇帝 啊	惊悚 电影迷
惊悚 电影迷	你 豆瓣 有 标记 么
你 豆瓣 有 标记 么	有 标记 不 多 几十 部
有 标记 不 多 几十 部	我 看到 有 10个 共同
我 看到 有 10个 共同	好多 没 标 懒
流云 小鸟  你 的 鞋 最喜欢	什么 鞋 啊 
什么 鞋 啊 	裸色 高跟 儿
你们 看 不看 another 的	求 普及 another 是 神马
你 这 不错 啊  我去 度娘 下	说错 了  是 动漫   
说错 了  是 动漫   	动漫    我 看完 从来不 记得 啊 
动漫    我 看完 从来不 记得 啊 	25 分钟 一 集  随便 看看 嘛
求 地址 啊         	同 求 啊       
扔 地址        啊 亲	
肿 么 样         	我 今晚 开 意向 
连接 在 哪  想看看 团 价 呢   	
   我 也想 团 不等 那个 包包	我也是 想 买 红色
我们 认识 吧  那 以后 找 我	呵呵 我 不 搞基
内心 不够 强大	如何 强大 
痛 不痛 啊	不痛 哈
取出 疼 吗	不 疼  全麻
酒窝 多少钱 怎么 弄 啊	1600两 边
俩 字 冷	是 风 大 还是 温度 低 啊 
是 风 大 还是 温度 低 啊 	明天 升温
遵义 是 剧院 不是 电影院 吧	对对 有趣
魔王 一如既往 的 善良  哈哈	不买 切糕 1
什么时候 走	放假了 就 走
什么时候 到	已经 到 了 的 说   
冷	能 给 个 具体 温度 么 
能 给 个 具体 温度 么 	零下 三 略带 小风  主要 是 风
宿舍 就是 个 大冰柜   	难道说     已经 停 暖 了 
难道说     已经 停 暖 了 	宿舍 暖气 坏 了
我 觉得 标题 的 对付 改成 对待 更 妥 	改 了  哈哈  我 觉得 也是 不 通顺 
反反复复 考验 对方 和 自己 吗 	双子座 会 这么 无聊 么 
同意	同意 反正 这个 搞 不定 我
我 也 527  哈哈	好久 没 上 豆瓣  握手 
扯淡	亲  你不懂 的 
我 老公 上升 也 天蝎	腹黑 吗  反正 我 挺 那个 啥 的  
好 早 啊  加油 	hoho 加油
m 正能量	谢谢 晚安
天庆 花园 店 嚒	对 哦
半 眯 啊 亲      	半 眯 看起来 好像 在 笑     
珍 しい君	海媛 小姐  我 看不懂 日语 啊   
m  	m
都 咬 到 了  小心点 哈哈	我不会 啊   
内服 芝麻  外 戴 墨镜	芝麻   开除 你 松鼠 鼠 籍
我知道 你是谁	能 不 吹 吗 
艺术 是 无价 滴	哈哈哈  这 话说 的 我 爱听
想 学画 啊 想 学画 木 时间 啊	等 我 晚班 开课 通知 你 哈   
等 我 晚班 开课 通知 你 哈   	很好 一定 通知 我 哈
很好 一定 通知 我 哈	
很 合理    喜欢	3 q 3 q
你 才 胡说  我 告 儿 老师 去 	hahaha
我 满意 的 笑 了	我 想象 出 你 笑 的 表情 了   
济南 欢迎 你 	8月 25 济南 专场  
一定要 来 大连	11111111111
欢迎 来 济南	
	谢谢 哈哈
谢谢 哈哈	哈哈  不客气 哇  一起 玩儿 嘛
欢迎 来 济南	8月 25 济南  
呼和浩特 等 你们 	1
来 济南 哭 一 气儿 啊	8月 25 济南 专场  
嗯 那 就是 刘蓉嘉    	怎么了 亲爱的
看来 你 真是 不想 活 了	呵呵 不理解
人家 也 跟 男 友邻 出来 吃饭 啦	那 你们 木有 遇到 男 友邻 的 好 基友 咩
原来 昨天 你 找 我去 是 在 演戏 阿	嫩 妹  你 吓 我 亲
我 问问 撒 好久 没 联系 他 了	阿里噶多
嗯  有 消息 给 偶 豆油  呵呵	好 的 咧
先生 你 的 节操 掉 了	哈哈
你 在 傲娇 什么 刘内裤	哈哈
哈哈	laogao 你 只 会 哈哈 嘛
适婚 的 女青年 最好 不要 去 么	呵呵
去 那里 干嘛     玩  读书 	出差
去 多久 啊 	一周
你 在 傲娇 什么 刘内裤	爱恨 情仇 断 不了  往事知多少 
爱恨 情仇 断 不了  往事知多少 	你好 我 是 春天 我爱 偶吧
不 去  辐射 大	啊哈  这个 理由 好
想要 樱花 明信片	中  到时 带 给 你 
带 好吃 的 	想吃 啥 
双 男 的 不爱 是 如何 表现  求解	就是 现在 对 你 那样
这个月 的 流量 还 没用 完好 捉 急 啊	下载 个 电影 试试    
上海 出发 	en  球 伴
算命 的 人 也 让 我不要 要	对啊 一切 都会 好 起来 的 放心 吧
你 又 不是 女生    	旅途中 是 部分 男女 的 呢
怕 神马 啊 说 走 就 背上 包 走	胆子 小  遇见 事儿 就怕  属 鸵鸟 的
呼应 标题党 么 	宾果
晕  初三 才 多 小 呀	你 是 说 哪里 小 啊
第一次 被 推 到 你 几 岁	我自己 是 22 啦
你 这 连环 贴 啊  哈哈	娱乐 嘛 你 怎么看
这么 容易 被 推	大叔 魅力 大
大姨妈 要 来了 	正在 来
一起 加油	恩恩    
浮躁 不好	就是 很 浮躁  我 该 肿 么 办
就是 很 浮躁  我 该 肿 么 办	我 刚 写 个 日记  大家 都 浮躁
我 刚 写 个 日记  大家 都 浮躁	恩  真的 很 浮躁  我 就 很 典型 
恩  真的 很 浮躁  我 就 很 典型 	你敢 和 我 比 浮躁
哈哈 这 叫 明确 的 阐述 	你 这 太狠 了 
我 是 你 信 么 	你 说是 我 就 信 啊  
你 说是 我 就 信 啊  	好 叻 信 我 哦 亲 
大哥 了   不能 含蓄 点 嘛	是 你 问 的 啊
是 你 问 的 啊	谁知道 你 这 孩子 这么 实诚 啊
我 是	真假 啊 亲
真假 啊 亲	恩哼  你 觉得 呢 亲
恩哼  你 觉得 呢 亲	我说 的 就是 你 可 真假 啊 亲
我们 都是 重口味 患者	这 就 重口味 么
双 可以 吗 亲 	双 的 都 不是 好 gay 
那 还 等 什么     	好处 啦啦啦
好吧好吧	然后 就木 有 然后 了 么  
女人 不 都是 有 例假 么	        
你 朋友 真相 呢	木真相   
木真相   	报名
报名	北京 就 免 了  
北京 就 免 了  	哪 的
哪 的	魔都
好 吧 你 也是 从 乡下 出来 的	这     有何 依据   
都是 因为你  害我 倒车 倒 来 倒 去 	哈哈 哈哈哈哈
绝对 可以 	宅 多 无益 身心健康  女孩 们 
叫 上 我 我 也 去 	哇哦 好 的
哇哦 好 的	那里 
征 人 的 额	应该 算 
已 豆 邮	收到  已 回 
198 帮顶 ) 3	神 id    仰视 一下
我 只 想要 个 生活 妹子 	soka    干 吧 碟
挽尊	挽尊 是什么 意思 亲 
找对象 跟 玩 豆瓣 有关系 吗	没关系  就 随便 问问
你 朋友 怎么 都 这么 惨	我 觉得 可能 是 自制力 不 强 的 原因 
是 我 的 另 一条 腿 压 到 她 了	你 一共有 几 条 腿 
见 谁 会 够呛  莉莉 和 树 哥 	话说 不是 吗
关 你 卵 路	莫噻 他 咯 
你 太 娇小 了 	是 我 的 另 一条 腿 压 到 她 了
是 我 的 另 一条 腿 压 到 她 了	哟 哟哟 
因为 脚臭 吗	可能 是   
我 呕 得 你 身上 了 吗 	那 我 会 打的 你 出 屎
sf	慢 啦 慢 啦
生 快	tx
生日快乐	谢谢 美伦
我 晕  刚 理解 这 句 话 什么 意思	哈哈哈 哈哈哈哈
啊 哦 大叔 喜欢 小萝莉	晕  我 就是 萝莉
晕  我 就是 萝莉	恩 啊 蜀黍 好喜欢你
恩 啊 蜀黍 好喜欢你	怪蜀黍 太 讨厌 了
怪蜀黍 太 讨厌 了	哟西
哟西	你 还 没 我 大 呢 
你 还 没 我 大 呢 	这 都 被 你 看出来 了 哟西
这 都 被 你 看出来 了 哟西	别         戳 中 喜好
别         戳 中 喜好	唉 洗洗睡 吧
唉 洗洗睡 吧	前 帝都 是 我 的 前 坐标
前 帝都 是 我 的 前 坐标	嗯哼
嗯哼	身 在 帝都  暂时 不想 走
我 是 认真 的  你 是 竹竿 么	不是 啊 亲
不是 啊 亲	认错人 了    囧
认错人 了    囧	恩 我 的 妆 画 的 比较好 
终结孤单	应该 是 新 歌吧  
回来吧 难道 你 不 怀念 吧	这          
为什么 不可以 是 oa oa	好像 也 可以 啊      
诺亚方舟 么 	不够 热烈  2012 刚好
额       oaoa 也 很 带 感	超级 带 感 噢 亲 很 嗨 啊
90 都 大龄	肿 么 办  我 是 大龄青年 了
喜欢 啊   	希望 他 以后 的 作品 可以 多点
基情 四射 吗  哈哈	是 啊 是 啊  哈哈
中意他	可爱 的 灿灿
1 l 大 亮	对对对  哈哈哈
上网 就是 上 了 以后 网住   	介样 啊 可是 上 谁 呢
介样 啊 可是 上 谁 呢	你看 你看 我 成 吗
噗 哈哈哈哈	不许 笑    严肃 点  
我们 宿舍 有个 活 在 古代 的 人	昭君 还是 西施 啊 亲  
昭君 还是 西施 啊 亲  	在 唐朝 的 话 可能 是 美女
在 唐朝 的 话 可能 是 美女	体重 没有 200 来 斤 的 不要 哦
体重 没有 200 来 斤 的 不要 哦	没有 吧 好像是 一百五十 多
没有 吧 好像是 一百五十 多	不要    太瘦 了 好 吗  
莫非太 重口 了 	伦家 太 苏 胡 了 啦
亲  思想 上 也是 柳下挥 么 	矮油 伦家 尊 的 不懂 嘛
嗯 我 从来不 上网   	真心 人 是 你 么
农村 妹子 都 不 知网 为 何物	就是 可以 抓鱼 的 辣 个   
孩子 你 太 天真 了	伦家 还是 cn 嘛
你 准备 多少 出 	300
雀斑 很可爱	话说 雀斑 灵感 来源 本人
豆油 1 是 删 楼	哈哈哈
你 哪里 的 呀 	利村
少 抽点烟 对 身体 不 好呀 喂	香烟 有害  健康
自学 口语 是 问题	同意 啊  打算 报 沪江 了 比较 便宜
只 会 弹舌      	下定决心 要 开始 学 了  
是 找 错别字 	不谋而合 了
好 吧 期待 你 的 照片	嗯  成  拍 了 告诉你  嘿嘿
chloechen	3 q
我 也想	嗯啊   
有 家 真好	是 的 啊   
退掉 吧	喷 了  退 不了 了   
多少 出	不知道    她 值 多少钱 
粉 蟹 出 么 	恩 暂时 不 粗 哈
马上 到	等 我 我心 惶惶
原谅我 只是 只 猴子	猴子 也有 春天 呐 亲
猴子 也有 春天 呐 亲	春天 在哪里 啊 春天 在哪里 
我 是 白晶晶	那你 是 来 找 2 师兄 的 么
神仙  妖怪  谢谢 	人妖  不客气
你 就说 你 是 个 猴 得了 	能 别 那么 直接 么
好	看看 租出去 没
现在 在 哪家 互联网 呀	芭乐 网 哦
留 地址 www	谢谢 拾 笙 祥瑞 御 免
排卵期 出血 吧	以前 都 木有 过 所以 不 淡定 了
你到底 知道 不	一看 就 不知道 呗
难道 木有 套马 的 汉子 么 	有  表演 的 要 花 银子 滴
呼伦贝尔 是 东部 区 的 么 	你到底 知道 不
你到底 知道 不	我要 是 知道  我 为 毛 还 用 问号 呢 
头颅 啊	你 是 
杀 花	嘿嘿
嗯  加油 吧  豆子	为什么 是 豆子
千万 别去 找气 生	
啊  你 是 在 济南 还是 北京 啊	
我 本来 今天 想 去 的  	
	哈哈 是 的
哈哈 是 的	
你 真 酷 	
感动 了  请 以身相许 吧 亲  	要不 今晚 
要不 今晚 	成交 
那么多 说法  死了 算了 	还 真 没 那么 坦荡  哎
巨蟹 男  绕 路 走	不是 吧
圣僧 哥哥	吃 我 肉 得不到 长生  好 么    
貌似 巨蟹 加天蝎 是 绝配   	我 怎么 记得 是 双鱼 
女生 怎么看 呢     	我 是 蟹 女  也 蛮 唠叨 的
为嘛 我 觉得 金牛 也是   	好人 星座 都 这样   
你 男友 也是 巨蟹 么   	不是 是 牛腩
不是 天蝎 啊   	好 吧    o ( ) o
好 吧    o ( ) o	貌似 巨蟹 加天蝎 是 绝配   
有   	豆油 吧 亲   
ok  开拍	等 下 给 我 消息 发 照片 给 我 哦 
我 喝 多 了  也 难受 的 不行 了	吃 点儿 解酒 地 就好 了   
确实  都 不算 朋友 的   	童鞋 你 多大 啊
你 忘了 京九线 了   c 总	就 一个   你 哪个
就 一个   你 哪个	只是 混 在 论坛 的 一个 潜水 党
其实 还有 一个 武昌 火车站   	请 看 内容 武汉站 和 武昌站
其实 还有 一个 武昌 火车站   	武昌站 不 就是 武昌 火车站 么
起码 有 20个	你 当是 地铁 么
坐 看 对话	搞 哦 
机友 乃 好	我 素女 银
我 素女 银	这样 啊  乃 真 妩媚  
你 七次  她 一次	太 深奥 了  恕 在下 不能 理会
太 深奥 了  恕 在下 不能 理会	我 也 不明白
你好  我 叫 为你 写诗 你看 行 么 	为你 点 唇 吧 
j 大 了	您 这 控制 能力 不行 
求 勾搭	不喜欢 男 的 
应该 不是 	那 褐色 的 那个 是 大姨妈 么 好 惶恐
1	这 是什么 牌子 的 美鞋  多大码
喜欢 那个 鞋子	125 包邮
m	要 的 话 125 包邮
9 最多  四个 9	那你 一定 是 90 后 了
3个 9 9 最多	那你 是 199 x 年 的 吧
那你 是 199 x 年 的 吧	90年 的
90年 的	纯粹 的 90 后 o ( ) o
五个 一 的  91.11.11	hehe
4个 1	91年 11月 
90年 的	我 也 90年 的
我 也 90年 的	握爪 o ( ) o
五个 一 的  91.11.11	您 是 六一 吧
91年 11月 	其实 我 也 想知道 4个 1 的 故事
明明 是 5 个 字	我 故意 的
我 故意 的	好 吧  你 赢 了
那你 今天 没 吃饭    	你 吃 了 吗 
你 吃 了 吗 	吃 了
吃 自己  住 自己  喝 自己   	那你 今天 没 吃饭    
280 一天  一个 月 8400 啊	工资 有 按 天 发 的 吗
看到 后 好 伤心 哦	可怜 的 女孩
可怜 的 女孩	你们 征 到 人 去 唱 k 了 撒 
你们 征 到 人 去 唱 k 了 撒 	没有
他们 还 小 不 懂事	做事情 都 不要 考虑 后果 的 嘛
吉林 延边 还是 大东北 好	我 去过 延吉  是 个 好地方
好吃 的 好玩 的 好 妹子	关注 你 了  
杭州 妹子 有	so 
我 觉得 自己 是  	小清新 和 金属 混合体 
小清新 和 金属 混合体 	是 啊  肿 么 了
黑龙江 金属 妞  在 江苏  	黑龙江 哪里 
黑龙江 哪里 	齐齐哈尔  
齐齐哈尔  	齐齐哈尔 是 个 好地方 
齐齐哈尔 是 个 好地方 	为什么  
为什么  	其实 我 也 没去过   猜 的
找到 工作 了  	么么哒
那 有 什么  	高 房价  别的 啥 都 没 0
你 这种 基佬 就 别来 搅 合 了	哈哈
杭州 看 演出 的 地方 怎么样	金属 场子 很少 的
金属 场子 很少 的	比 没 的 看 强 
我 四 杭州人 但 我 不是 妹纸	也 可以 交 个 朋友 撒
也 可以 交 个 朋友 撒	好 啊
好 啊	杭州 看 演出 的 地方 怎么样
月光石 戴 哪 只 手	我 带 的 左手
做起来  好难 	那你 跟 谁 恋爱 会 幸福 呢
那你 跟 谁 恋爱 会 幸福 呢	是 我自己 应该 放 对 位置 
怎样 让 他 主动  不理 他 么 	培养 你 的 魅力 诶 去 吸引 他
刚刚 哭 过 	我 想 去 喝酒
你 要 遭 不住	10086
你 要 遭 不住	1
可是 睡不着 呢   	死
那 就 下辈子 见吧	只能这样 了 o ( ) o
只能这样 了 o ( ) o	撒 油 拿 辣 甘拔袋
撒 油 拿 辣 甘拔袋	纳什 什么 ( o )
纳什 什么 ( o )	意思 就是 我 很 饿
刚 打 了 个 电话 没人 接	网上 订餐 o ( ) o
网上 订餐 o ( ) o	kfc 的 外送 范围 不 包括 我们 这里
然后 天亮了  魂飞魄散 了 	呜呜 呜呜
好 悲伤    	悲伤 逆流 成 河
海燕 呐 你 可 长 点心 吧	本山 啊 你 可 别来烦我 了
哎呀 我 的 上帝 啊 	上帝 赐予 你 左手
预祝	感谢 
感谢 	客气
我擦 生命 太 脆弱	让 我 如何 拯救 这 破碎 的 世界
看完 怎么 那么 慎 得 慌	睡去 吧 妹子
睡去 吧 妹子	刚醒
刚醒	再 睡
再 睡	睡不着 了
睡不着 了	好 吧
好 吧	我等着 吃 午饭 呢
我等着 吃 午饭 呢	我 的 午饭 还 不知道 在哪里 呢 哎
好样儿 的 	嘻嘻
太 惊悚 了	哈哈哈
哈哈哈 啊哈哈 	好笑 么 亲
好笑 么 亲	非常 
   好 吧 我 再也不 熬夜 了	回头是岸
死 是 另 一种 生 	你 去 生 吧 再会
真的 是 说 的 没错 呢	让 每 一个 夜晚 充满 夜猫子 的 灵魂
校友 帮顶   	欢迎加入
不要 侮辱 我 的 mr big   	怎么 侮辱 了 
f 又是 哪个  好 跳跃    	f 是 买 cd 的 那个 大学生
上 处男 遭 报应 吗 亲 	同 问
n 是 截止 到 y 以前 吗  我 混乱 了	n 是 y 之后 的
这 算是 技术 贴 么	你可以 当 技术 贴 看
上 处男 遭 报应 吗 亲 	你 给 人 包 个 红包 就好 了
双鱼 	天平 呵呵
天平 呵呵	哦  失误 
哪 直接 插 不 就好 了	你 的 生活 少 了 很多 乐趣 啊
播 完了 	是 的
哇靠 我 帮 你 推广	xx 党 肯定 把 我 列 黑名单 呵呵
射手 	又 错 了
又 错 了	难 不成 是 双鱼 么
难 不成 是 双鱼 么	错 了
天平	乃 可恶 死了  竟然 是 天秤
乃 可恶 死了  竟然 是 天秤	呵呵 天平 怎么了 
毕竟 像 这样 的 还是 少数 吧	表 告诉 偶  乃 已经 真相 过 了
签 完了	  这么快
登徒子 一枚	额 可以 这么说
郁闷 了	怎么  工作 上 出 什么 问题 了 
额 已经 猜 到 结局 了 么 	结局 尚 早 同 厌恶 心机 女
这 是 最后 内 位 么 	不是 中间 还有 插曲
为什么 要 注销 呢 	现在 不是 流行 注销 前大吐槽么
额 这 是 夸 我 还是 损 我 呢 	夸
26个 字母 应该 也 齐 了	没有 那么多 吧 
没有 那么多 吧 	加上 隐藏 起来 的
客气	别 瞎 寒暄 了  赶紧 的  正题
此 贴 为 技术 普及 贴 啊     	好 吧  认真 学习 洗耳恭听
呵呵 回来 一起 聊	可怜 我 只能 吃糠 咽 菜 了
n 是 双鱼 	对 怎么 看出来 的 
好 吧  给 哀家 跪安 吧	孤 刚 收拾 完 回来 准备 再 写 点
在 哪 见过 你	乃是 谁 
豆瓣 女 貌似 海米 粗线	豆瓣 女 在 中 后 部分 了
你 给 人 包 个 红包 就好 了	为什么 有 这个 传说 啊
你 认识 我 	你 是什么 职业
go on	你 又 出现 了
原来 大家 家里 都 备 着 酒 呢	酒精 是 通往 另 一 平行 世界 的 钥匙
真好  我 好久 没 卖 过 碟 了	闲置 摆 出来 了 你可以 去 看看
我靠  大口 该是 原 碟	有 口 盘 有 原 盘
白羊  不会 是 吧	错 了
歌 叫 什么	你 是 我 心爱 的 姑娘
我 当初 也是 听 着 这首歌 睡意 全 无 啊	这么说 下去 一千 显然 没问题
多大 了 啊	今年 该 25 了   
播	好 执着     
好 吧 原谅你	还 真是 大方 来
还 真是 大方 来	自然
女 的 学 这个 有 什么 用 啊	了解 不行 啊 
了解 不行 啊 	床上 技巧 多 做 多 总结
床上 技巧 多 做 多 总结	受教 了
受教 了	客气
说 的 好	来吧 我 紧贴 你
说 的 好	谢谢支持
怎么 还 不 赶紧 到 春节   	盼望 着 盼望 着  
昂 谢谢 最佳 路人 丙	不客气
支持 支持	嗯嗯  我 会 全力以赴 的
嗯嗯  我 会 全力以赴 的	弯 了 记得 通知 我们
弯 了 记得 通知 我们	一句话
我喜欢 软妹	什么叫 软妹 啊 
我喜欢 软妹	亲 的 头像 很 有爱 呢
呵呵 其实 饿 们 都 喜欢 美好 的 事物	对呀 对呀
一时 头晕目眩 而已	万一 不是 呢 
支持 出柜	我 还 么 的 对象 嗳
上 真相 就会 有人 追 你 了	想 追 我 的 直接 关注 我 的 豆瓣
那 我 得 去 看看 了	弯 了 可 就 直 不 回来 了 三思 啊
弯 了 可 就 直 不 回来 了 三思 啊	么 的 事 嗳
所以 你 没有 在 担忧 是 吗     	担忧 什么 呢 
能 把 你 掰弯 的 那个 t 很 帅气 么 	小 女人  
小 女人  	小 女人  看来 她 的 气场 蛮 强大 带
我 也 以为 抢 了 老婆 1	我 也 以为 抢 了 老婆 1
我 也 以为 抢 了 老婆 1	n
学姐  有 索马里 语 的 真题 么 	那个 真 没有 哦  我 只有 法语 滴
鹦鹉 好 萌	fabo 的 画 都 很 萌 哦
帮顶 	谢谢
木有	那 看看 吧  我想你 肯定 会 喜欢  
那 看看 吧  我想你 肯定 会 喜欢  	谢谢
占 个 座 啊	欢迎  第三位    嘿嘿
占 个 座 啊	哈 那么 我 鼓掌
聊 什么	木 主题 诶
飘	欢迎欢迎 
坐等 下班	坐等 毕业 
坐等 毕业 	毕业 后 呢 哪个 方向 找工作
你 还是 学生 么	算是 吧 但是 呢 也 在 工作
我 表示 我也是 这样   	你 个 妖人    哈哈
敢问 女侠 的 桌面 是什么 图 	各种 在 大叔 眼里 不 正常 的 图
太 不会 享受 生活 了 你    	是 的  m 是 城市 的 好 海 纸
大腿 肌肉 疼	额  看医生 吧
我 撤 了    	去哪里 了  先武昌 长沙
旅游 之后 一般 都 很累 的	是 的  好 要命 啊 
有点 小 生气 了    	为什么  求 赐教
刚 还在 玩	你 玩 什么 
挺起 你 的 脊梁   	我 一 直挺 着呢
还是 试一试 敷 毛巾 吧	小心 今天 腿 废掉  哈哈   
教育 大 楼门口   	干嘛 呢 
围观   	围观 到 神马  帅哥  美女 
你好 邪恶	必须的 
淡定   	必须的 蛋定 
有 蛋糕 吃 么 	给 礼物 就 给 蛋糕 吃   
还有 不要 恶意 装 萌    	伦家 一直 很 萌 的
我 长 得 有 那么 丑 么 	无法 直视   
无法 直视   	      
我在 合肥 怎么 知道 这事 	好 吧  我 就 大度 的 原谅你 吧
还 没 毕业 呢 	没 啊  才 大二 呢 
我 大学 有钱 滴 时候 吃 的 是 小炒	有木有 特别 值得 一 吃 的 
搓麻将 k歌 有没有 场子 啊	有木有 人 组织 啊   
母 的	擦
卤 藕 而已 么	她 念叨 一晚上 了
玮 爷 真 猛 啊  盖 了 这么 高 了	必须的  玮 爷 是 生猛 的 汉子
陶然 的 藕  你 在 哪  	吃货 别这样   
我来了	一边 去
突然 觉 的 好想 你 	我 也 很 想你  
听说过 武功 再 高  也 怕 菜刀 么	黄蓉 有 软 猬 甲 呢 不怕
没 听 过  百度 貌似 不详  有 深意 	你 若 喜欢 我们 就 深刻 交流 一下 啊
坐标 是 哪里 	上海
任泉        	有个 年龄段 还 真 像 过
好心动   	心动 不如 行动 啊 
亲 实在 是 掰 不 弯 呐 	纳尼 
好男人  内 牛 满面	坐标 是 硬伤  我 也 内 牛 满面
你 的 头像 和 名字  都 很   	很 啥 
很 啥 	额  很 有 特点   
额  很 有 特点   	既然 这么 有 特点  还 不 赶紧 豆油 
太 长	写 的 长 了 点  没办法
过 会 看 	嗯哼
	  
不错	谢谢
武汉 是 个 恋爱 的 好 城市 	其实 也 没 不过 武汉 小吃 多 喔
其实 也 没 不过 武汉 小吃 多 喔	求 呼唤  我 杭州 的 
说错 了  是 求 互换  哈哈	怎么 个 换 法 呐 
云南 丽江	呼呼 木偶 有 虾米 建议 么 
我 论文 还 没 开始 折腾	同样 还 没 折腾 完
怎么 呢	学 内 关系 校 留学
还好 吧 至少 过得去	真好 诶
真好 诶	呵呵 岛国 你 懂 的
呵呵 岛国 你 懂 的	那 以后 是 要 回国 的 伐 
那 以后 是 要 回国 的 伐 	最终 肯定 会 回来
最终 肯定 会 回来	祖国 人民 欢迎 你 哈哈
我 不是 姑娘	这  那 我 又 犯傻 了
这  那 我 又 犯傻 了	从 哪儿 觉得 我 是 姑娘 真心 问
从 哪儿 觉得 我 是 姑娘 真心 问	头像 里 就是 个 姑娘 嘛 抿嘴
嘿嘿 唔	看 你 乐 的   
看 你 乐 的   	捂嘴 儿 啦啦啦
捂嘴 儿 啦啦啦	说 点 什么 吧
恩啊 一定要 去 的 啊	应该 来 的 行 万里路 胜 读书
应该 来 的 行 万里路 胜 读书	是 啊心灵 在路上
青空 哇 你 也 消失了 么	我 没 消失 啊 嘿嘿
satisfy me	咕噜咕噜 咕噜咕噜
陪我 聊天 呗 在 干嘛 呀	恩 你 开头
也 没 个人 跟 我 偷摸 的	好像 我 刚才 跟 你 偷摸 的 了
无视 数学 	就算 无视 也 还 的 学 啊
哈哈  好 的  	放心
原来 你俩 认识 的  	不 认识 不 认识 这 我 刚 认识 她
要不 都 认识一下	好 的 哇  咱 都 认识一下 呗 
哈哈 我也是 宅女 一枚	这个
这个	哈哈 该打
对对 我 收藏 了	害羞 ing
额 咱 彼此彼此 了	哈哈 握手
这个   哈哈 我 也 想吃	周黑鸭是超好吃 的 哇
哈哈  欧克 你 在 哪儿 呐	我 现在 在 河南 上班 啊
估计 你 是 遇上 对手 了  	哈哈 闭关 修炼 一番
哈哈 借 你 点 太阳	恩  好 呢 知道 了 嘛
恩  好 呢 知道 了 嘛	唔 怕怕
失忆 你 负责 啊 呼呼 贼 笑	恩  好吧 都 回忆起 来吧
恩  好吧 都 回忆起 来吧	回忆 需要点 什么 才能 回忆 的 起来 哇
你是谁 呐 唔	额 好 吧 我 自恋 了
原来 你俩 认识 的  	7 你 错 了 哟 不 认识 哎
还是 吃肉 比较 靠谱 哈哈	呀  咋 没人 说话 了 呢
第一 终极目标 是 娶老婆 是 吧 	对呀  难道 你 要 帮 我 实现 
我 也 不 悠闲 好伐	额  你 在 纠结 你 的 论文  
我 的 肯德基 来啦 哈哈	恩  好 呢 哦
额 话说 我 真 不想 在 河南 这	那 就 去过 一个 城市 嗯 果断 的
必须的 嘛  哈哈	哇 两全其美 呐 呼呼
哇 两全其美 呐 呼呼	就是 就是  要 乖 哦
就是 就是  要 乖 哦	一直 都 很乖 好伐
一直 都 很乖 好伐	这样 啊 乖 的 妹妹 才 有 糖 吃
这样 啊 乖 的 妹妹 才 有 糖 吃	是 嘛 是 嘛 那 快 把 糖 交出来 
是 嘛 是 嘛 那 快 把 糖 交出来 	额
好像 我 刚才 跟 你 偷摸 的 了	咦 你们 俩
咦 你们 俩	嘘   低调 明白 就 行 了
你们 都 shi 哪里 去 了 哟	我来了 的
我来了 的	我 千呼万唤 才 出来  
不 蛋 不 蛋类	来了 来了
恩  哦 了	哈哈 大步 向前走
无视 数学  	午安  
午安  	醒了 没  都 快 黑天 了
年轻真好  我 依然 老 了	年轻真好  我 依然 老 了 1
年轻真好  我 依然 老 了 1	有 错别字  
有 错别字  	啊 
啊 	应该 用 已然
小说 终于 敲定	才女 啊  还 写 小说
好 热闹 你们 几个	shinwa 来 参加 更 热闹 哇
哟 羡慕 啊	羡慕 啥  
羡慕 啥  	羡慕 能 随时 去 香港 呗
可能 七 八月份 会 去 的 喔	哈哈  来 嘛  没问题
什么叫 小包子 身材  嗯 	就是 自己 想 啊
就是 自己 想 啊	额 那你 损 我 啊
午安 今天 依旧 很好 天气	因为我 每天 都 和 你 说 安  
因为我 每天 都 和 你 说 安  	哈哈哈
我来 报名 了	报名 什么 的 最好 了
报名 什么 的 最好 了	还 得 面试 么
还 得 面试 么	哈哈
英语 啊	歌词
哈哈 可以 的 早安	嗯哼 早上好
去 西藏 是 个 不错 的 选择	去 西藏 怕 自己 不能 适应
once 主题曲 不是 么 	对啊 对啊
对啊 对啊	我 也 一度 循环 这个 歌 魔怔 一般
司法 考试	不 宅 你 法学 专业 哟 
不 宅 你 法学 专业 哟 	嗯  悲剧 的 被 调剂 到 法学 了 
嗯  悲剧 的 被 调剂 到 法学 了 	抱抱 四年 都 过来 了
又 写 不 出来 了	那 就 放 着 有 灵感 了 再 写
那 就 放 着 有 灵感 了 再 写	恩 啊  主要 是 卡 着 结尾 了
那 就 放 着 有 灵感 了 再 写	不 宅 不 宅
不 宅 不 宅	我不会 告诉你 我 又 荒废 了 一天 
我不会 告诉你 我 又 荒废 了 一天 	怎么 呢
中场休息  出来 换气 	干嘛 呢 不 宅
你猜 嘿嘿	以己度人  法学 
好 吧	我 是 当 小说 看 的
手机 党 现身	哟 早安
哟 早安	快 到时候 说 晚安 了 
活 干完 了  没 地方可 去 	那 就 发发呆
看电影 了  钢的琴	那 我 看书 了 随便 拿 起 本 小说
外出 做 笔录 归来 	晚上 了 哟 亲
看 闲书  不想 写 论文 	我 也 看看 闲书
去 西藏 怕 自己 不能 适应	不 去 怎么 知道 
不 去 怎么 知道 	对 喔 本来 就 应该 尝试 趁年轻
啊 呸	呀 干吗
呀 干吗	啊 呸
啊 呸	呸 too
喝完 酒 回来 了	唔 不是 戒酒 类
其实 我 觉得 喝酒 有时候 是 真性情	那 我 性情 还不错
那 我 性情 还不错	哈哈 好 吧
哈哈 好 吧	看样子 你 也 挺 有 量 的 啊
唔 是 要 我 夸 你 么  哈哈	不用 谢谢
小心 胖 的 跟 我 一样	巴不得 能 胖 个 十 斤 呢
巴不得 能 胖 个 十 斤 呢	小胖妞
小胖妞	巴不得 是 小胖妞 呢
哈哈 我也是 宅女 一枚	湘妹子 还是 很不错 的
建筑 专业 么  	土木工程
土木工程	我们 学校 都 木有 这个 专业 的 说
我们 学校 都 木有 这个 专业 的 说	理工科 学校 大部分 都 有
那你 说 你 是 给 我 吃 还是 不 给 吧	废话 必须 地 给 啊
我家 可是 良田 万 亩 牛羊 成群	大家 快来 这里 有个 大款
大家 快来 这里 有个 大款	没事 来 我家 偷菜
没事 来 我家 偷菜	记得 带上 家属
记得 带上 家属	可能 一会 就 熟 了 你 准备 好 啊
可能 一会 就 熟 了 你 准备 好 啊	我要 吃肉
我要 吃肉	农场 也有 的
往往 都 学 不到 自己 喜欢 的 专业 的	可是 太难 太难 找工作 了
可是 太难 太难 找工作 了	学 什么 的
学 什么 的	你猜 嘿嘿
有奖竞猜 哟	
	唔 想到 个 好 容易 猜 的 说
唔 想到 个 好 容易 猜 的 说	那 就 说呗
那 就 说呗	还是 保留 不说 了 嘿嘿
哎哟	嘿嘿
嘿嘿	不许 嘿嘿
我 帮 你 	我 是 说 l  满意 否
我 是 说 l  满意 否	原来 叫 evil 比较 随意
我 就不 信 我 翻 不 过去	估计 这 一晚上 也 翻 不 过去 了
估计 这 一晚上 也 翻 不 过去 了	我 功劳 可 大 了 去 了
我 功劳 可 大 了 去 了	给 你 一朵 大红花 好 吧
给 你 一朵 大红花 好 吧	兑现 我 这 可 当真的
兑现 我 这 可 当真的	那 我努力 翻
那 我努力 翻	我 时候 是 你 送 我 大红花 的 事情
这 也 都是 我 手机 里面的 撒	明显 学我 好伐
明显 学我 好伐	瞎说 是 你 学我 的 好伐
我 是 一个 可以 把 人 吃 穷 的 人 呐	我家 可是 良田 万 亩 牛羊 成群
我家 可是 良田 万 亩 牛羊 成群	大款 啊
我 正在 喝牛奶	明显 学我
明显 学我	我 几乎 每天 晚上 都 喝 得 好 吧
不喜欢 纯 的 就 买 浑浊 的 啊	哎哟 甜 的 也 不错 抿嘴
哎哟 甜 的 也 不错 抿嘴	换个 口味
换个 口味	为 虾米 要 换  
又 不 乖 了 啊	l l 出来 呗
l l 出来 呗	w
现在 你 才 听   这	很早 很早 之前 就 听 过
很早 很早 之前 就 听 过	切
切	又 不 乖 了 啊
又 不 乖 了 啊	啊 呸
啊 呸	怎么 今天 又 吐 了 
好女孩	看来 大家 都 睡 鸟 出来 呗
看来 大家 都 睡 鸟 出来 呗	就 咱俩 了 也 不用 偷摸 了
你 这 是 那 我在 吸引 吸引 别的 人 啊	哈哈 快点 去 广 个 播 哈哈
哈哈 快点 去 广 个 播 哈哈	有 我 还 不够 吗 
有 我 还 不够 吗 	想 和 女生 聊 的 说
想 和 女生 聊 的 说	那 先 回避 吧
那 先 回避 吧	哎哟 不要 嘛
哎哟 不要 嘛	呵呵
呵呵	
熄灯 在即 关灯 看 小说 去	哼
哼	
你 说话 算数 吗 	你 觉得 呢
额 你现在 哪呢	我在 学校 呢 啊
我在 学校 呢 啊	学校 哪呢
学校 哪呢	学校 在 河北
学校 在 河北	搜 噶 离 武汉 好 远 好伐
各种 车 都 到	特快 到 吗  周黑鸭 都 涨价 了
特快 到 吗  周黑鸭 都 涨价 了	涨价 你 都 清楚 呢  
涨价 你 都 清楚 呢  	你 还 说什么 都 到 涨 了 一块
你 还 说什么 都 到 涨 了 一块	走路 也 到 的 伐 哈哈
走路 也 到 的 伐 哈哈	还是 要去 西班牙 风情街 那 吃
还是 要去 西班牙 风情街 那 吃	我 今儿 就 在 西班牙 风情街 那儿
我 今儿 就 在 西班牙 风情街 那儿	
	咕噜咕噜
减肥 	嗯 减一减
敏锐	我 翻页 的
我 翻页 的	我也是
今天 太阳 好好 天气 好好	我 这里 很大 的 风 而且 降温
我 这里 很大 的 风 而且 降温	我 感觉 武汉 的 春天 来了
我 感觉 武汉 的 春天 来了	春意盎然 的
春意盎然 的	啦啦啦 最喜欢 的 五月 也 要 来了
怎么 光 想听 别人 的 感情 事 啊	不告诉 你 哼 就不 告诉你
坏人	讨厌
讨厌	啊 呸
啊 呸	额汗 是 有点 萌 了 啊 哈哈
额汗 是 有点 萌 了 啊 哈哈	啊 呸
啊 呸	出来 吃 早晚 是 要 吐 得
出来 吃 早晚 是 要 吐 得	停
停	ol
satisfy me	看来 都 听 过 啦 哈哈
话说  我 也 喜欢 五月天 哈	好 诶
我 已经 睡醒 一觉 了	bs 扔下 众人 独自 去 睡觉 的
今年 准备 继续 考  考 完 再 找工作 	考 哪个 证 啊  
考 哪个 证 啊  	司法 考试
中场休息  出来 换气 	额 你看 车子 呢 
哟  都 这么 早睡 呢	还 没 睡 的 说
你 哪 的  	河北    威武   
等 天晴 了 暖和 点 就 开 了	嘿嘿 我 祈求 星期一 开   
膜拜 下	千万 别  过 没 过 还 不知道 的   
我 刚 工作 也 怀着 这个 梦 呢	果断 报名 吧    拼 一下
会 定时 滴滴 报时 么	还 没 研究 呢 哈哈 考 完 放 一边 了
可以 可以  只要 我 能 帮 到 的 话	嗯 谢谢 啦 
欢迎	能 象征性 给 点 干股 么 
给 需要 入股 呢 	欢迎
克耍克 青旅 当 义工	有 意义 啊
样 都 不 讲  立马 睡 个 懒觉 	减肥 给 成功 了 
那 该 多好 啊	那你 请 你 的 boss 赶紧 啊
谢谢  再见 	简单 明了 啊
我 心里 早 把 你 fire 了	然后 呢 
然后 呢 	然后 收收 东西 潇洒的走 啊
然后 收收 东西 潇洒的走 啊	让 你 潇洒 走 一 回 
痛苦 并 快乐 着	人生 就这样 
很 是 感谢 然后背 起 包 流浪 去	流浪 使 你 不再 寂寞 
流浪 使 你 不再 寂寞 	生来 孤独  怎么会 不 寂寞 
旅游	再 烧 2个 糯 包谷 
难怪 我不会 胖	哈哈 哈哈哈哈  难怪 你 是 我 哥 
太 感谢 了  一起 出去 喝 一 台	杨林肥 酒 
来  左右眼 都 用 完了 	那 就 碰 脑壳 啦
求真相	什么 真相 
什么 真相 	兼职 麻豆 的 真相
哦 我 还 猜测 失误 了 	嘿 
我 回来 了 你 有 什么 想 问 的	吃 的 什么 面
厉害 厉害	久病 了 总能 成 医 的
没啥 放不下 的 看 得 淡	活 的 不够 热烈
劝 不住 是 啥 情况	放不下  看 不 开 
自己 把 自己 劝 住 了 	现实 总能 慢慢 把 各种 自己 给 劝 住
祝 你 快乐	亲  你 真 乖 
33	叔
起床 吃早餐 了 	我 也 该 睡 了 
算了  不 评论 兰大 了  生气 	子 不 嫌 母 丑 啊  
同感	为什么   生气 呢
算了  不 评论 兰大 了  生气 	同感
兰大 心理学 好 么 	心理学 一般般 
普通 女 女 报名	普通 女 女 报名 1
我 想 找人 4.2--8 出去 散心	去哪 啊 姐
什么 然后  呜    有人 咩  坐等	等 着 然后 呢
哪有 啊  米 有 收到 你 的 消息 啊	网络 慢  稍 等 哈
不可以	呜呜呜 呜呜 呜呜 呜呜呜
呜呜呜 呜呜 呜呜 呜呜呜	我 都 没 报   
要不 我 怎么 是 你 的 好 闺蜜 呢	嗯  好 闺蜜  一辈子
你 就 答 我 是 啊	已经 发 过去 给 你 了
已经 发 过去 给 你 了	收到 了  亲
收到 了  亲	嗯 有个 是 茂名 的 诶
嗯 有个 是 茂名 的 诶	不用 了  闺蜜 一个 就 够
回去 看	这些 东西 希望 对 你 有用
裸 辞	什么 意思
最近 一周 内 吧	哦  一周 内  估计 我 还 没法 离职
我 也 要 跳 了 	备 好 降落伞 
备 好 降落伞 	泪 恐高 
泪 恐高 	眼睛 一 挣 一 闭 就 过去 了
这个 占星 的 网址 是 	81 盘
	呵呵 谢谢你 我 打算 另 发 一个
	哈哈 谢谢你 你 真好
白羊 理论 上  和 狮子 最 配 	为 神马
下一代 没 那么 快出来	7  8 月 
为 暑假 换 苹果 而 m	m 是 啥 意思 求解释
嗯 最近 也有 欲望 想 买 m 好	神马 神马 都 好 就是 相当 费 电
我 从 厦门 过去 啊	你 什么时候 到 啊
这个时候 的 婺源 最美	嗯 嗯嗯 期待 呀
周末 也是 人 最多 的   	清明 人 更多 了
出 出出	散粉 的 色 号 和 价格 
有 靠谱 网店 给 介绍一下 吗 	这个 看我的 签名
不看 海贼 的 人生 是 不 完整 的	矮油  我们 的 人生 都 完整 了  哈哈
看过 5 遍 的 我  会 随便 乱说 么 	羡慕 啊  有 这么多 时间
刚 把 得   	o ( ) o
还 可以 包邮哦 	( )
经常 这样 做  然后 再也不 联系 了	那 还是 会 有 新 的 好朋友 吗 
头像 是 无幻	呵呵  是 片尾 截 的 
已 豆油  莫 辜负	已 回复 
已 回复 	没收 到  估计 中途 堵车
有趣	如何 有趣 洗耳恭听
谢谢你 的 自 多 哈哈	注意安全
问问  同事 好像 要买	嘿嘿  好 滴 好 滴
那 可以 买 港行 的  亲  嘿嘿	港行 的 你 不是 4 咩 
港行 的 你 不是 4 咩 	是 4 s 呀  亲  打 错 咧
我 是 狮子 男 我在	  温暖 系 狮子 男
坐标 一样 歡	我 吗  嘿嘿 那 赶紧 来 握爪 嘛  
我 吗  嘿嘿 那 赶紧 来 握爪 嘛  	握爪
8.11 的 狮子 男 路过	正宗 的 狮子座 的 男 森
嗯哼	又 看到 你 了      
我 猜 合适	我 猜 也 合适  
我 猜 也 合适  	哈哈  
哈哈  	泡椒鸡爪 才 好吃
泡椒鸡爪 才 好吃	e
狮子女 挺好 哈	嗯哼
嗯哼	啊哈 抱抱
嗯  我 是 狮子 男 	你好 我 也 要 努力 奔跑
你好 我 也 要 努力 奔跑	一起 跑跑 
狮子女 和 狮子 男 合适 吗 	我 猜 合适
喊 我 干嘛 	大家 来 耍 嘛
我喜欢 狮子女   	店长   打折 不
店长   打折 不	还 没 开     
最近 觉得 狮子男 很可爱	可爱 点 好
在 着 里	看着你 了
贱贱 地 走过 	那个 状语 是 神马 意思  
那个 状语 是 神马 意思  	炫耀 得瑟 一下 
炫耀 得瑟 一下 	得瑟   敲 头 之 
得瑟   敲 头 之 	嬉笑 之 
哈哈 四川 处女 狮 来 咯 	和 我 一样 嘛 
和 我 一样 嘛 	你 也是 8.22 
冇问题 啊 啊哈哈	那 就 揍 成 李瘦子
那 就 揍 成 李瘦子	为 什 黱 是 李
为 什 黱 是 李	李和张 都是 大姓 嘛
张冠李戴 黱 	这 是 李冠张 戴噢 也
两 狮子 合适 吗 	瘦子 瘦子 我 是 微胖 纸
狮子 男 来了    	翻 迎 噢   
翻 迎 噢   	谢谢 
是 很 搭	所以 啊 狮子 男 在哪里 
所以 啊 狮子 男 在哪里 	恩组里 都是
你 不够 帅 	你以为 中戏 都是 帅哥 
你以为 中戏 都是 帅哥 	因为你 太帅 
因为你 太帅 	你 逻辑 真好 大爷 不让 进
还好 啊	我 是 说 水平
我 是 说 水平	看 不 出来 不懂
看 不 出来 不懂	原来 你 是 中戏 的
原来 你 是 中戏 的	这 都 让 你 发现 了
自然 点 走进去 就 行 了	得 嘞 好 的
得 嘞 好 的	进去 了 没
锣鼓巷 现在 漂亮 不	商业化 了 更 没了 原来 的 韵味
不用 出示 学生证 什么 的 吧	不用
就怕 走 不下去	有时候 就是 需要 一种 坚定 
有时候 就是 需要 一种 坚定 	也是 哈
必须 共同 喜欢 	那 也 挺好 的
找 个 迷 弟 嫁 了  是 件 幸福 的 事	恩 都 喜欢 五月天 应该 会 很 幸福
很 想 可 也 只是 想想	想想 也许 就能 成真
我喜欢 的 	恩恩 喜欢 五月天 多好 啊
保佑 我们 不会 分手	嗯 祝福
这 伤感 了	恩恩
好 远  住 城乡结合 部 的 表示 无力 	阿            
水 	是 是 是  我 水 完了
a 叔 你 都 不 来 看场子  真的 是	晚上 我 要去 打 羽毛球
晚上 我 要去 打 羽毛球	羽毛球 停电 了  打 不成
羽毛球 停电 了  打 不成	不会 的 绝对 不得
你们 来 南门 嘛   	     我在 问 你 的 嘛
好 远  住 城乡结合 部 的 表示 无力 	你 又 搬家 了  
这个 需要 请示 领导 啊	领导 在 哪儿
有没有 美女	现在 不晓得 有 没得 阿 
再见	啥 意思
恭喜 啊    	恭喜 个 毛 
这个 方法 好	好 个 p 
呵呵  你们 都是 好人   	0 人生 第一 卡      泪奔
要是 可以 再 随性 一点 就 更好 了	难度 好 大   
亲爱的 唱 的 比 关于 棒	最近 经常 反复 亲爱的
我 只 想 求 谱        	
好听  喜欢 	长沙 的 握爪  
长沙 的 握爪  	嗯嗯  握爪
求 吉他谱	
我 倒是 打算 清明 去 临沂 玩 的	呜呜呜   
怎奈 干 得 是 产品 这一块   	对 淘宝 有兴趣  也 欢迎
杀	理由 
那 得 看 你 放 多大 的 片子 了	最大 到 a 4 纸 大小 左右 的 就 可以
1 坐标 是 	杭州 出发  1 号 晚 到 屯溪
想起  顶	走 起 吖  清明 就该 出去 
用水 养 着 的 	你 才 知道 没 文化 真 可怕
陌生 的 地方  陌生 的 人 	你好  陌生人
我 已经 不想你 了  那么 你 呢 	人 总是 在 自欺欺人 
关注 一下	谢谢你 
关注 一下	谢谢你
楼 主考 北航 哪儿 啊	想 考 五 系 的 飞 设  嘿嘿嘿
mark	再 m 就 没有了
没 图 你 让 我 说什么	不好 拍吧 那么多 人    
全 是 小男人 满腹 矫情 的 味道 	10086
巨蟹 	挺好 一 星座
好好研究吧 我 伤心 去 了	嗯  适当 伤心 就 够了 
嗯  适当 伤心 就 够了 	撕心裂肺 的
撕心裂肺 的	没必要 
对 我等着	加油
哈哈哈 居然 又 看到 了	你 起 得 也 真 早
好 煽情 啊	没 煽动 你  很明显
10086	也 可以 99966
有 故事 的 人	编 故事 的 人 么
每个人 都 有 自己 的 故事 吧 	也 对
也 对	
	哎桑 不 起
哎桑 不 起	找点事 来 做 吧
找点事 来 做 吧	有事 做 怠工 ing
有事 做 怠工 ing	人 一 闲 下来 就 容易 寂寞 啊
人 一 闲 下来 就 容易 寂寞 啊	对啊 呵呵呵
对啊 呵呵呵	所以 要 让 自己 变得 忙 起来 啊
      	
广州 很 安全 啊 人 都 很 实在 的	多 实在 要 吃 要 喝 要 回家 
ls 太 伤人 了	这 是 一针见血
因为你 长 得 丑	好 吧
我 就坐等	等 来 一句 你 好丑
等 来 一句 你 好丑	我靠 你
我靠 你	你 拿 神马 靠 我 
你 拿 神马 靠 我 	你能 安慰 下 我 吗
你能 安慰 下 我 吗	不行
长 的 丑 的 是 不会 有人 来 安慰 的	你能 不能不要 这么 伤 我
我 也 觉得	接触 一段时间 看看 喽
接触 一段时间 看看 喽	我 就坐等
哦哦	话说 吉艺 怎么样 呀
吉艺 的 	是 啊
有 发展前途 吗	我 也 不知道 所以 才 来 这 问
    先知 也有 吃 零食 的 权利 	突然 感觉 那个 先知 好像 你
幽游白书	1
一起 啊  沙发	加油 明晚 一起 打卡
加油 明晚 一起 打卡	我 晚上 都 不吃 诶  
有些微 小说 写 得 可以	我也是 天秤座
我也是 天秤座	哈哈天平 最好 了
哈哈天平 最好 了	我 还是 觉得   
你 对 这东西 过敏  换个 口味 试试	重口味 么   
重口味 么   	可以 尝试 下
可以 尝试 下	大部分 还是 无 压力 的   
大部分 还是 无 压力 的   	那 就 加 重点
我来 和 你 搭伙 吧 	噗    靠谱 点 行 么
噗    靠谱 点 行 么	我 难道 不 靠谱 吗 
就算 上映  肯定 剪 去 三分 二 哭	同意 tat
就算 上映  肯定 剪 去 三分 二 哭	有 这么 不和谐 吗  
别 指望	要是 能 搞 到 高清 蓝光 的 也好 啊 
能说 流利 汉语 普通话      	说 的 对 
看到 it  我 立马 闪 了	it 怎么了  
哈哈 是 啊 我 多数 不 冷静	天儿 太热 
同意 同意  	re 1
没有  你 有 微博 吗  	哦  我以为 大家 都 有
你 哪里 的 呀	帝都          
拜托  你 回复 的 我 这里   	我 是 说 我 赞同 你 的 建议  
我 是 说 我 赞同 你 的 建议  	好 吧
能说 流利 汉语 普通话      	是 呀
it男 都 谢顶 吧	我 不是
看到 这个 想到 了 一个 人	家人 
家人 	是 啊
是 啊	那 赶紧 拿下 吧
那 赶紧 拿下 吧	拿下 谁 
拿下 谁 	像 家人 的 他
像 家人 的 他	本人 人 丑 体 胖 公鸭嗓
本人 人 丑 体 胖 公鸭嗓	好 了 对了 豆 邮 吧
好喜欢 这个 参数 的 身材	不 胖 不 瘦 呗
it 怎么了 	it 不好 吗
看到 it  我 立马 闪 了	it 怎么了
不是	早
来 一个	哎呦   亲 ( 3 ) 居然 在
呀  原来 是 学姐  顶一下	哎 乖  给 你 糖
偶吧 哈吉马	纳尼 
索隆 小北   	你 认识  
河北    	对 你 呢 
对 你 呢 	me too
不喜欢 1	天涯 页面 太 乱 了   不喜欢 啊 
天涯 页面 太 乱 了   不喜欢 啊 	发帖子 少于 200 字 还 不让
我 基本 不上 天涯  都 在 豆瓣 蹲点	1
刚好 相反 的 过程     	me too
然后 呢 	蓝 后  我 的 毛毛 没有了
瞬间 想到 了 海绵宝宝   	我 瞬间 想到 了 尼莫
去 看看 狗 吧	总 养狗 也 太 没 挑战性 了
可怜 的 水母	可怜 的 我
我 是 秤 女	那你 对 狮子 男 什么 印象 啊
秤 女 来看 直播 了	谢谢哈  我 会 努力 的
我 	现在 吗 亲          
再 让 他 追 一会 考验 一下 他	下次 约会 还 去 不
强吻 过 几个 这样 说 会 被打 么	为什么 要 强吻 呢
会 顺水推舟	什么 意思
	啥 意思 啊 整 的
怎么 想 的	都 这么 想 吧
好 吧  我 彻底 凌乱 了	确实 很 乱   
真 悲催  那么 年轻 就 不行 了	呃  没法 说  悲催
现在 离婚 都是 常事 了  	对于 女 的 来说 还是 会 有 一定 影响 的
倒霉 啊	介绍 给 我 我 帮 她嘎嘎嘎嘎嘎
买 根 黄瓜	不是 长久之计吧 
能 问问 男主角 是 怎么 个 不行 法 么	不 举 
性 功能 是 干什么 用 的	   问 度娘
这 婚 结 的 各种 不 靠谱	闪婚  的确 不行
找 个 火包 友	火包 友 是什么 意思 
好 惆怅	又 有你 在 帖 里
正解       加分	给 我 加 没用 啊 主要    
还有 黄瓜  	冷静 
这个 不够 动感 吧	要求 别太 高
技术 好 可以 弥补	那 为什么 不 直接 找 个 完整 的 呢
那 为什么 不 直接 找 个 完整 的 呢	她 不是 已经 找 错 了 么
她 不是 已经 找 错 了 么	我说 的 不是她 是 没 结婚 的
要 试婚      哈哈哈	试 过 了 吗  嗨皮 了  唉
到底 怎么 个 不行 法 	无法 硬
    这 这 这 有点 杯具 	太 悲剧 了 不然  太 郁闷 了
婚前 不 试 保守 完 坑 了 自己	主要 真是 点背 了   碰上 这么 个人
离婚 早 离 早 超生	我也是 这么 觉得 的
人民 英雄 纪念碑 好嘛	好 吧  永垂不朽  
这 段子  不让 人 欢乐 啊	哈哈 
需要 激情 啊	必须 激情  年轻轻 的 还 需要 折腾 呢
   难道 你   	额            
额            	哈哈  了解 了 嘘
女人 就是这样 挑 来 挑 去 的	   这 肯定 得 挑 啊
多好 啊 纯纯 的 恋爱 真好	嗯 哥们 羡慕 吧
果断 离婚 啊 	好 吧  希望 她 能 放下 吧   
我 和 你 想 的 一样   	嗯嗯  握爪
男 的 是 ed 	ed 是什么 意思
遮住 脸 也 不行 么 	看 身材 如何 了
有图 吗 	   什么 图 
结婚 变成 结 分 	结 分  我 费解 了
好 惆怅	特别 纠结  真的
  	汗颜 吧 小心 哦
研究 配 中专 路数 对不上	唉 门当户对 吧  哈哈
衣服 牌子 是什么 	我 比喻 下 家庭 背景
我 比喻 下 家庭 背景	呃  好 吧  门当户对 不无道理
呃  好 吧  门当户对 不无道理	嗯 对 还是 要 验货 的
幸好 我 正常 	恭喜恭喜
也是 啦 哈哈哈哈	就是 就是 嘛
倒霉 啊	让 那男 的 去 看病
那 事 就 那么 有意思 吗	你 觉得 有意思 吗 
这个 不是 重点 他 也 不会 隐瞒	也是 的   
早 发现  早 治疗 	他 不 治  哭 吗 
必不可少 啊	必须 必须的 必不可少 啊
必须 必须的 必不可少 啊	那 是 必须 必 的
中国式 逼婚 各种 坑爹 有木有	嗯嗯  太 对了 真 悲催
嗯嗯  太 对了 真 悲催	还是 自由 恋爱 的 好
还是 自由 恋爱 的 好	这 就是 自由 恋爱
婚前 必须 验货  还要 拿 秒表 计时 	   呃  专业 啊
离 了 记得 在 帖子 里 更新	   机会 啊
这个 悲催 了	确实 很 悲催 的  亲
一个 研究生 和 中专	悲催 的 组合
三个 月 都 不够 了解 的	带 那个 男人 去 看 老 军医 吧
带 那个 男人 去 看 老 军医 吧	他 态度 强硬 说 自己 没问题 
一定要 婚前 试用 啊  	不能说 一定  试用 不尽是 坏处 
唉 门当户对 吧  哈哈	老祖宗 留下 的 东西 不是 完全 没用 的
你 的 信箱 估计 要 爆满	我 猜 也是  啊哈哈
	彼此彼此 啦
额     这么 悲催	要 小心 哦  亲
应该 知道	那 这个 性质 就 完全 不一样 了
离 了 吧	嗯  肯定 得 离 了
各种 情感 分析 帝 好 欢乐	你 也 来讲讲 
没有    不行 怎么 破    	用 手 也 可以 破     
用 手 也 可以 破     	   深 了
遮住 脸 也 不行 么 	你以为 小龙女 啊
你以为 小龙女 啊	嘻嘻
人性 丧失 包括 喜欢 背后 造谣 么 	造谣 
不知道  你可以 自己 捏捏   	就 因为 不知道 所以 想 问问 阿＝＝
就 因为 不知道 所以 想 问问 阿＝＝	问 错 人 了
   我 感觉 似的 	就是 嘛     
就是 嘛     	击掌
他 自己 不 治  这点 让 人 很 崩溃 	男人 的 面子 和 自尊 问题 吧
男人 的 面子 和 自尊 问题 吧	那 没人 跟 他 耗 着 吧 
我 就 想知道 怎么 个 不行 法	不 硬
认命 吧  逃 不了	唉 结婚 刚 俩 星期
唉 结婚 刚 俩 星期	作 吧
呃  我 只是 觉得 姐们儿 太 可怜 了	可怜 之 人 必 有 可恨 之 处 没 听 过 嘛 
可怜 之 人 必 有 可恨 之 处 没 听 过 嘛 	唉
鼓浪屿 据说 很小 厦大 还行	小 没关系  五脏俱全
小 没关系  五脏俱全	哈哈  说 得 好
交易 前 不 验货 后果 自负	现在 就 吃 黄连 了 呗
稳住	摊 上 这样 的 事儿  能 稳 的 住 嘛 
求 坐标 啊	北京
可 我 被 我 男朋友 踹 了   	不 识货  不稀罕 
硬 不了 好 恐怖 啊  肯定 是 gay 	有别的 解释 吗 
不是 每个 中华 女儿 都 能 做到 的  亲	让 她 帮 他 口 吧
让 她 帮 他 口 吧	管用 吗 
没有 感情 基础   	也 不能 说一点 没有 了解 不够
不 硬	这 算 啥 啥 事 啊  唉
这 算 啥 啥 事 啊  唉	倒霉 啊
你 都 没有 满足感 多 难受 啊	是 没 觉得 满足 过
是 没 觉得 满足 过	那 你现在 对 他 什么 感觉
那 你现在 对 他 什么 感觉	依然 很 爱 啊
离 了 么   	没 听说
这 贴 永垂不朽 啊	呀  你 又 出现 了  哈哈哈
不好  怎么办 啊 	咋 啦 饿 肚子 了  咱 吃 呷哺 去
是 的 啊 走 着 走 起	嗯  想 走 起 就 走 起 最近 天气 不好
还以为 会 偷梁换柱	暗度陈仓 吧 还是  哈哈
暗度陈仓 吧 还是  哈哈	哈哈
关键 问题 找 代理 的 吧	什么 意思 
什么 意思 	找 个性 有 能 的 不 就好 了 不 差事
说 乱 了	咋 的  
还在 啊	永垂不朽 了
永垂不朽 了	我说 对了
我说 对了	是  你 赢 了
哈 恭喜你	恭喜 我 什么  我 这 又 烦躁 又 无聊 的
恭喜 我 什么  我 这 又 烦躁 又 无聊 的	烦躁 神马 无聊 神马
诶 无聊 呢 思密达	怎么办 呀
怎么办 呀	诶 给 你 豆油 了
离 了 吗 	没 呢  女方 在 咨询 法律 相关 条例 把
没 呢  女方 在 咨询 法律 相关 条例 把	我 是 想说 赶快 劝 离 而已
我 是 想说 赶快 劝 离 而已	搜 噶 快 了 估计  呵呵
哈哈 我去 和 女 的 试试	嗯  试试 自己 行不行 吧  哈哈
